#########################
A #     #       #   #   #
# ### # ### ### # # ### #
# #   #     #   # #   # #
# # ######### ### ### # #
#   #       # #   # # # #
##### ##### # # ### # # #
# #   #   # #   #   # # #
# # ##### # ####### # # #
# #     # #         #   #
# ##### # ##### ### ### #
# #   # #   # # #   #   #
# # # # # # # # ##### ###
#   #     #   #         B
#########################