###########
#A  #    #
# # # ## #
# #   #  #
# ### # ##
#     # B#
###########
