##?#####?#######?##??????
A.#.....#.......#.R ?????
#.###.#.###.###.#.#??????
#.#...#.....#...#.#??????
#.#.##?######.###.#??????
#...#???????#.#...#??????
?###????????#.#.##???????
????????????#...#????????
?????????????###?????????
?????????????????????????
?????????????????????????
?????????????????????????
?????????????????????????
?????????????????????????
?????????????????????????