##?#####?#######?###?###?
A.#.....#.......#...#...#
#.###.#.###.###.#.#.###.#
#.#...#.....#...#.#...#.#
#.#.#########.###.###.#.#
#...#.......#.#...#?#.#.#
?####.#####.#.#.##??#.#.#
#.#...# ..#.#...#???#.#.#
#.#.#####.#.####### #.#.#
#.#.....#.#........R#...#
#.#####.#.#####.### ?##.#
#.#...#.#...# #.#???#...#
#.#.#.#.#.#.#.#.#####.##?
#...#.....#...#....... ??
?###?#####?###?#######???