##?#####?#######?###?###?
A.#.....#.......#...#...#
#.###.#.###.###.#.#.###.#
#.#...#.....#...#.#...#.#
#.#.#########.###.###.#.#
#...#.......#.#...# #.#.#
?####.#####.#.#.###.#.#.#
#.#...# ..#.#...# ..#.#.#
#.#.#####.#.#######.#.#.#
#.#.....#.#.........#...#
#.#####.#.#####.###.###.#
#.#...#.#...# #.# ..#...#
#.#.#.#.#.#.#.#.#####.###
#...#.....#...#.........B
?###?#####?###?##########