##?#####?#######?###?????
A.#.....#.......#...#????
#.###.#.###.###.#.#.##???
#.#...#.....#...#.#...#??
#.#.##?######.###.###.#??
#...#???????#.#...#?#.#??
?###????????#.#.##??#.#??
????????????#...#???#.#??
?????????????###????#.# ?
????????????????????#..R#
?????????????????????## ?
?????????????????????????
?????????????????????????
?????????????????????????
?????????????????????????