##?#####?#######?###?????
A.#.....#.......#...#????
#.###.#.###.###.#.#.#????
#.#...#.....#...#.#R ????
#.#.##?######.###.##?????
#...#???????#.#...#??????
?###????????#.#.##???????
????????????#...#????????
?????????????###?????????
?????????????????????????
?????????????????????????
?????????????????????????
?????????????????????????
?????????????????????????
?????????????????????????