##?#####?#######?###?###?
A.#.....#.......#...#...#
#.###.#.###.###.#.#.###.#
#.#...#.....#...#.#...#.#
#.#.##?######.###.###.#.#
#...#?? R...#.#...#?#.#.#
?###????###.#.#.##??#.#.#
??????????#.#...#???#.#.#
??????????#.####????#.#.#
??????????#..... ???#...#
???????????####.#????##.#
??????????????#.#???#...#
??????????????#.#####.##?
??????????????#....... ??
???????????????#######???