##?#####?#######?###?###?
A.#.....#.......#...#.R.#
#.###.#.###.###.#.#.###.#
#.#...#.....#...#.#...#.#
#.#.##?######.###.###.#.#
#...#???????#.#...#?#.#.#
?###????????#.#.##??#.#.#
????????????#...#???#.#.#
?????????????###????#.#.#
????????????????????#...#
?????????????????????## ?
?????????????????????????
?????????????????????????
?????????????????????????
?????????????????????????