##?#####?#######?###?###?
A.#.....#.......#...#...#
#.###.#.###.###.#.#.###.#
#.#...#.....#...#.#...#.#
#.#.##?######.###.###.#.#
#...#???????#.#...#?#.#.#
?###????????#.#.##??#.#.#
????????????#...#???#.#.#
?????????????###????#.#.#
????????????????????#...#
?????????????????????##.#
????????????????????#...#
????????????????????#.##?
???????????????????? R ??
?????????????????????#???