##???????????????????????
A.#??????????????????????
#.#??????????????????????
#.#??????????????????????
#.#??????????????????????
#.R ?????????????????????
?##??????????????????????
?????????????????????????
?????????????????????????
?????????????????????????
?????????????????????????
?????????????????????????
?????????????????????????
?????????????????????????
?????????????????????????