##?#####?#######?????????
A.#.....#.......#????????
#.###.#.###.###.#????????
#.#...#.....#...# ???????
#.#.##?######.###R#??????
#...#???????#.#...#??????
?###????????#.#.##???????
????????????#...#????????
?????????????###?????????
?????????????????????????
?????????????????????????
?????????????????????????
?????????????????????????
?????????????????????????
?????????????????????????