##?#####?#######?###?###?
A.#.....#.......#...#...#
#.###.#.###.###.#.#.###.#
#.#...#.....#...#.#...#.#
#.#.#########.###.###.#.#
#...#.......#.#...#?#.#.#
?####.#####.#.#.##??#.#.#
??#...#???#.#...#???#.#.#
??#.####??#.####????#.#.#
??#.....#?#..... ???#...#
? ?####.#??####.#????##.#
#R#...#.#?????#.#???#...#
#.#.#.#.#?????#.#####.##?
#...#... ?????#....... ??
?###?###???????#######???