##?#####?#######?###?###?
A.#.....#.......#...#...#
#.###.#.###.###.#.#.###.#
#.#...#.....#...#.#...#.#
#.#.#########.###.###.#.#
#...#.......#.#...#?#.#.#
?####.#####.#.#.##??#.#.#
#.#...#???#.#...#???#.#.#
#.#.####??#.####????#.#.#
#.#.....#?#..... ???#...#
#.#####.#??####.#????##.#
#.#...#.# ????#.#???#...#
#.#.#.#.#R#???#.#####.##?
#...#.....#???#....... ??
?###?#####?????#######???