##???????????????????????
A.#??????????????????????
#.#??????????????????????
#.# ?????????????????????
#.#R#????????????????????
#...#????????????????????
?###?????????????????????
?????????????????????????
?????????????????????????
?????????????????????????
?????????????????????????
?????????????????????????
?????????????????????????
?????????????????????????
?????????????????????????