##?#####?#######?###?###?
A.#.....#.......#...#...#
#.###.#.###.###.#.#.###.#
#.#...#.....#...#.#...#.#
#.#.#########.###.###.#.#
#...#.......#.#...#?#.#.#
?####.#####.#.#.##??#.#.#
#.#...#???#.#...#???#.#.#
#.#.####??#.####????#.#.#
#.#.....#?#..... ???#...#
#.#####.# ?####.#????##.#
#.#...#.#R ???#.#???#...#
#.#.#.#.#.#???#.#####.##?
#...#.....#???#....... ??
?###?#####?????#######???