##?#####?###?????????????
A.#.....#.R. ????????????
#.###.#.###.#????????????
#.#...#.....#????????????
#.#.##?#####?????????????
#...#????????????????????
?###?????????????????????
?????????????????????????
?????????????????????????
?????????????????????????
?????????????????????????
?????????????????????????
?????????????????????????
?????????????????????????
?????????????????????????