##?#####?#######?????????
A.#.....#.......#????????
#.###.#.###.###.#????????
#.#...#.....#...#????????
#.#.##?######.##?????????
#...#???????#.#??????????
?###????????#.#??????????
????????????#.R ?????????
?????????????##??????????
?????????????????????????
?????????????????????????
?????????????????????????
?????????????????????????
?????????????????????????
?????????????????????????