##?#####?######??????????
A.#.....#.....R ?????????
#.###.#.###.###??????????
#.#...#.....#????????????
#.#.##?#####?????????????
#...#????????????????????
?###?????????????????????
?????????????????????????
?????????????????????????
?????????????????????????
?????????????????????????
?????????????????????????
?????????????????????????
?????????????????????????
?????????????????????????