##?#####?#######?###?###?
A.#.....#.......#...#...#
#.###.#.###.###.#.#.###.#
#.#...#.....#...#.#...#.#
#.#.#########.###.###.#.#
#...#.......#.#...#?#.#.#
?####.#####.#.#.##??#.#.#
#.#...#???#.#...#???#.#.#
#.#.####??#.####????#.#.#
#.#.....# #..... ???#...#
#.#####.#R#####.#????##.#
#.#...#.#. ???#.#???#...#
#.#.#.#.#.#???#.#####.##?
#...#.....#???#....... ??
?###?#####?????#######???