##?#####?#######?###?###?
A.#.....#.......#...#...#
#.###.#.###.###.#.#.###.#
#.#...#.....#...#.#...#.#
#.#.#########.###.###.#.#
#...#.......#.#...#?#.#.#
?####.#####.#.#.##??#.#.#
??#...#???#.#...#???#.#.#
??#.##????#.####????#.#.#
??#..R ???#..... ???#...#
???###?????####.#????##.#
??????????????#.#???#...#
??????????????#.#####.##?
??????????????#....... ??
???????????????#######???