##?#####?#######?###?###?
A.#.....#.......#...#...#
#.###.#.###.###.#.#.###.#
#.#...#.....#...#.#...#.#
#.#.#########.###.###.#.#
#...#.......#.#...#?#.#.#
?####.#####.#.#.##??#.#.#
#.#...# ..#.#...#???#.#.#
#.#.#####.#.####????#.#.#
#.#.....#.#..... ???#...#
#.#####.#.#####.#????##.#
#.#...#R#...# #.#???#...#
#.#.#.#.#.#.#.#.#####.##?
#...#.....#...#....... ??
?###?#####?###?#######???