##?#####?#######?###?###?
A.#.....#.......#...#...#
#.###.#.###.###.#.#.###.#
#.#...#.....#...#.#...#.#
#.#.##?######.###.###.#.#
#...#???????#.#...#?#.#.#
?###????????#.#.##??#.#R#
????????????#...#???#.#.#
?????????????###????#.#.#
????????????????????#...#
?????????????????????## ?
?????????????????????????
?????????????????????????
?????????????????????????
?????????????????????????