##?#####?#######?????????
A.#.....#.......#????????
#.###.#.###.###.#????????
#.#...#.....#...#????????
#.#.##?######.##?????????
#...#???????#.#??????????
?###????????#.#??????????
????????????#R ??????????
?????????????#???????????
?????????????????????????
?????????????????????????
?????????????????????????
?????????????????????????
?????????????????????????
?????????????????????????