##?#####?#######?###?????
A.#.....#.......#...#????
#.###.#.###.###.#.#.##???
#.#...#.....#...#.#...#??
#.#.##?######.###.###.#??
#...#???????#.#...#?#.#??
?###????????#.#.##??#R#??
????????????#...#???? ???
?????????????###?????????
?????????????????????????
?????????????????????????
?????????????????????????
?????????????????????????
?????????????????????????
?????????????????????????