##?#####?#######?###?????
A.#.....#.......#...#????
#.###.#.###.###.#.#.##???
#.#...#.....#...#.#..R#??
#.#.##?######.###.### ???
#...#???????#.#...#??????
?###????????#.#.##???????
????????????#...#????????
?????????????###?????????
?????????????????????????
?????????????????????????
?????????????????????????
?????????????????????????
?????????????????????????
?????????????????????????