##?#####?#######?###?????
A.#.....#.......#...#????
#.###.#.###.###.#.#.##???
#.#...#.....#...#.#...#??
#.#.##?######.###.###.#??
#...#???????#.#...#?#.#??
?###????????#.#.##??#.# ?
????????????#...#???#.#R#
?????????????###????#.#.#
????????????????????#...#
?????????????????????## ?
?????????????????????????
?????????????????????????
?????????????????????????
?????????????????????????