##?#####?#######?###?###?
A.#.....#.......#...#...#
#.###.#.###.###.#.#.###.#
#.#...#.....#...#.#...#.#
#.#.##?######.###.###.#.#
#...#???????#.#...#?#.#.#
?###????????#.#.##??#.#.#
????????????#...#???#.#.#
??????????? ####????#.#.#
??????????#R.... ???#...#
???????????####.#????##.#
??????????????#.#???#...#
??????????????#.#####.##?
??????????????#....... ??
???????????????#######???