##?#####?#######?????????
A.#.....#.......#????????
#.###.#.###.###.#????????
#.#...#.....#? R#????????
#.#.##?#####???#?????????
#...#????????????????????
?###?????????????????????
?????????????????????????
?????????????????????????
?????????????????????????
?????????????????????????
?????????????????????????
?????????????????????????
?????????????????????????
?????????????????????????