##???#???????????????????
A.#? R ??????????????????
#.###.#??????????????????
#.#...#??????????????????
#.#.##???????????????????
#...#????????????????????
?###?????????????????????
?????????????????????????
?????????????????????????
?????????????????????????
?????????????????????????
?????????????????????????
?????????????????????????
?????????????????????????
?????????????????????????