##?#####?????????????????
A.#.....#????????????????
#.###.#.### ?????????????
#.#...#....R#????????????
#.#.##?#####?????????????
#...#????????????????????
?###?????????????????????
?????????????????????????
?????????????????????????
?????????????????????????
?????????????????????????
?????????????????????????
?????????????????????????
?????????????????????????
?????????????????????????