##?#####?????????????????
A.#.....#?? ?????????????
#.###.#.###R#????????????
#.#...#.....#????????????
#.#.##?#####?????????????
#...#????????????????????
?###?????????????????????
?????????????????????????
?????????????????????????
?????????????????????????
?????????????????????????
?????????????????????????
?????????????????????????
?????????????????????????
?????????????????????????