##?#####?#######?###?###?
A.#.....#.......#...#...#
#.###.#.###.###.#.#.###.#
#.#...#.....#...#.#...#.#
#.#.#########.###.###.#.#
#...#.......#.#...#?#.#.#
?####.#####.#.#.##??#.#.#
#R#...#???#.#...#???#.#.#
#.#.####??#.####????#.#.#
#.#.....#?#..... ???#...#
#.#####.#??####.#????##.#
#.#...#.#?????#.#???#...#
#.#.#.#.#?????#.#####.##?
#...#... ?????#....... ??
?###?###???????#######???