##?#####?#######?###?###?
A.#.....#.......#...#...#
#.###.#.###.###.#.#.###.#
#.#...#.....#...#.#...#.#
#.#.#########.###.###.#.#
#...#.......#.#...#?#.#.#
?####.#####.#.#.##??#.#.#
??#...#???#.#...#???#.#.#
??#.####??#.####????#.#.#
??#.....#?#..... ???#...#
???####.#??####.#????##.#
??????#.#?????#.#???#...#
??????#.#?????#.#####.##?
?????? R ?????#....... ??
???????#???????#######???