##?#####?#######?###?###?
A.#.....#.......#...#...#
#.###.#.###.###.#.#.###.#
#.#...#.....#...#.#...#.#
#.#.#########.###.###.#.#
#...#.......#.#...#?#.#.#
?####.#####.#.#.##? #.#.#
#.#...# ..#.#...#? R#.#.#
#.#.#####.#.#######.#.#.#
#.#.....#.#.........#...#
#.#####.#.#####.### ?##.#
#.#...#.#...# #.#???#...#
#.#.#.#.#.#.#.#.#####.##?
#...#.....#...#....... ??
?###?#####?###?#######???