##?#####?#######?###?###?
A.#.....#.......#...#...#
#.###.#.###.###.#.#.###.#
#.#...#.....#...#.#...#.#
#.#.#########.###.###.#.#
#...#.......#.#...# #.#.#
?####.#####.#.#.###.#.#.#
#.#...# ..#.#...# ..#.#.#
#.#.#####.#.#######.#.#.#
#.#.....#.#....R....#...#
#.#####.#.#####.###.###.#
#.#...#.#...# #.# ..#...#
#.#.#.#.#.#.#.#.#####.##?
#...#.....#...#....... ??
?###?#####?###?#######???