##???????????????????????
A.#??????????????????????
#.#??????????????????????
#.#??????????????????????
#.# ?????????????????????
#..R#????????????????????
?###?????????????????????
?????????????????????????
?????????????????????????
?????????????????????????
?????????????????????????
?????????????????????????
?????????????????????????
?????????????????????????
?????????????????????????