##?#####?#######?###?###?
A.#.....#.......#...#...#
#.###.#.###.###.#.#.###.#
#.#...#.....#...#.#...#R#
#.#.##?######.###.###.#.#
#...#???????#.#...#?#.#.#
?###????????#.#.##??#.#.#
????????????#...#???#.#.#
?????????????###????#.#.#
????????????????????#...#
?????????????????????## ?
?????????????????????????
?????????????????????????
?????????????????????????
?????????????????????????