##?###???????????????????
A.#.R. ??????????????????
#.###.#??????????????????
#.#...#??????????????????
#.#.##???????????????????
#...#????????????????????
?###?????????????????????
?????????????????????????
?????????????????????????
?????????????????????????
?????????????????????????
?????????????????????????
?????????????????????????
?????????????????????????
?????????????????????????