##?#####?#######?###?###?
A.#.....#.......#...#...#
#.###.#.###.###.#.#.###.#
#.#...#.....#...#.#...#.#
#.#.#########.###.###.#.#
#...#.......#.#...#?#.#.#
?####.#####.#.#.##??#.#.#
??#R..#???#.#...#???#.#.#
??? ##????#.####????#.#.#
??????????#..... ???#...#
???????????####.#????##.#
??????????????#.#???#...#
??????????????#.#####.##?
??????????????#....... ??
???????????????#######???