##?#####?#######?????????
A.#.....#.......#????????
#.###.#.###.###.#????????
#.#...#.....#...#????????
#.#.##?######.##?????????
#...#???????#.#??????????
?###????????#R#??????????
????????????? ???????????
?????????????????????????
?????????????????????????
?????????????????????????
?????????????????????????
?????????????????????????
?????????????????????????
?????????????????????????