##?#####?#######?????????
A.#.....#.......#????????
#.###.#.###.###.# ???????
#.#...#.....#...#R#??????
#.#.##?######.###.#??????
#...#???????#.#...#??????
?###????????#.#.##???????
????????????#...#????????
?????????????###?????????
?????????????????????????
?????????????????????????
?????????????????????????
?????????????????????????
?????????????????????????
?????????????????????????