##?#####?#######?###?###?
A.#.....#.......#...#...#
#.###.#.###.###.#.#.###.#
#.#...#.....#...#.#...#.#
#.#.#########.###.###.#.#
#...#.......#.#...#?#.#.#
?####.#####.#.#.##??#.#.#
#.#.R.# ..#.#...#???#.#.#
#.#.#####.#.####????#.#.#
#.#.....#.#..... ???#...#
#.#####.#.#####.#????##.#
#.#...#.#...# #.#???#...#
#.#.#.#.#.#.#.#.#####.##?
#...#.....#...#....... ??
?###?#####?###?#######???