##?#####?#######?????????
A.#.....#.......#????????
#.###.#.###.###.#????????
#.#...#.....#...#????????
#.#.##?######.###????????
#...#???????#.#.R ???????
?###????????#.#.#????????
????????????#...#????????
?????????????###?????????
?????????????????????????
?????????????????????????
?????????????????????????
?????????????????????????
?????????????????????????
?????????????????????????