##?#####?????????????????
A.#.....#????????????????
#.###.#.#????????????????
#.#...#R ????????????????
#.#.##?#?????????????????
#...#????????????????????
?###?????????????????????
?????????????????????????
?????????????????????????
?????????????????????????
?????????????????????????
?????????????????????????
?????????????????????????
?????????????????????????
?????????????????????????