##?#####?#######?###?###?
A.#.....#.......#...#...#
#.###.#.###.###.#.#.###.#
#.#...#.....#...#.#...#.#
#.#.#########.###.###.#.#
#...#.......#.#...#?#.#.#
?####.#####.#.#.##??#.#.#
??#...#???#.#...#???#.#.#
??#.####??#.####????#.#.#
? #.....#?#..... ???#...#
#R#####.#??####.#????##.#
#.#...#.#?????#.#???#...#
#.#.#.#.#?????#.#####.##?
#...#... ?????#....... ??
?###?###???????#######???