##?#####?#######?###?????
A.#.....#.......#...#????
#.###.#.###.###.#.#.##???
#.#...#.....#...#.#...# ?
#.#.##?######.###.###.#R#
#...#???????#.#...#?#.#.#
?###????????#.#.##??#.#.#
????????????#...#???#.#.#
?????????????###????#.#.#
????????????????????#...#
?????????????????????## ?
?????????????????????????
?????????????????????????
?????????????????????????
?????????????????????????