##?#####?#######?###?###?
A.#.....#.......#...#...#
#.###.#.###.###.#.#.###.#
#.#...#.....#...#.#...#.#
#.#.#########.###.###.#.#
#...#.......#.#...#?#.#.#
?####.#####.#.#.##??#.#.#
??#...#???#.#...#???#.#.#
??#.####??#.####????#.#.#
??#.....#?#..... ???#...#
???####R#??####.#????##.#
??????? ??????#.#???#...#
??????????????#.#####.##?
??????????????#....... ??
???????????????#######???