##?#####?#######?###?###?
A.#.....#.......#...#...#
#.###.#.###.###.#.#.###.#
#.#...#.....#...#.#...#.#
#.#.#########.###.###.#.#
#...#..R....#.#...#?#.#.#
?####.#####.#.#.##??#.#.#
#.#...# ..#.#...#???#.#.#
#.#.#####.#.####????#.#.#
#.#.....#.#..... ???#...#
#.#####.#.#####.#????##.#
#.#...#.#...# #.#???#...#
#.#.#.#.#.#.#.#.#####.##?
#...#.....#...#....... ??
?###?#####?###?#######???