##?#####?#######?###?###?
A.#.....#.......#...#...#
#.###.#.###.###.#.#.###.#
#.#...#.....#...#.#...#.#
#.#.##?######.###.###.#.#
#...#??? R..#.#...#?#.#.#
?###?????##.#.#.##??#.#.#
??????????#.#...#???#.#.#
??????????#.####????#.#.#
??????????#..... ???#...#
???????????####.#????##.#
??????????????#.#???#...#
??????????????#.#####.##?
??????????????#....... ??
???????????????#######???