##?#####?#######?###?????
A.#.....#.......#...#????
#.###.#.###.###.#.#.#????
#.#...#.....#...#.#.R ???
#.#.##?######.###.###????
#...#???????#.#...#??????
?###????????#.#.##???????
????????????#...#????????
?????????????###?????????
?????????????????????????
?????????????????????????
?????????????????????????
?????????????????????????
?????????????????????????
?????????????????????????