##?#####?#######?###?????
A.#.....#.......#...#????
#.###.#.###.###.#.#R#????
#.#...#.....#...#.# ?????
#.#.##?######.###.#??????
#...#???????#.#...#??????
?###????????#.#.##???????
????????????#...#????????
?????????????###?????????
?????????????????????????
?????????????????????????
?????????????????????????
?????????????????????????
?????????????????????????
?????????????????????????