##?#####?#######?###?###?
A.#.....#.......#...#...#
#.###.#.###.###.#.#.###.#
#.#...#.....#...#.#...#.#
#.#.#########.###.###.#.#
#...#.......#.#...#?#.#.#
?####.#####.#.#.##??#.#.#
#.#...#???#.#...#???#.#.#
#R#.####??#.####????#.#.#
#.#.....#?#..... ???#...#
#.#####.#??####.#????##.#
#.#...#.#?????#.#???#...#
#.#.#.#.#?????#.#####.##?
#...#... ?????#....... ??
?###?###???????#######???