##?#####?####????????????
A.#.....#...R ???????????
#.###.#.###.#????????????
#.#...#.....#????????????
#.#.##?#####?????????????
#...#????????????????????
?###?????????????????????
?????????????????????????
?????????????????????????
?????????????????????????
?????????????????????????
?????????????????????????
?????????????????????????
?????????????????????????
?????????????????????????