##?#############?#?###?###?#####?#######?#######?
A.#.............#.#...#...#.....#.......#.......#
#.#.#####.###.#.#.#.#.#.#.#.#.#.#.###.#.#.#####.#
#.#.#...#.# #.#...#.#.#.#...#.#.#.. #.#.#.#.....#
#.#.#.#.#.#.#.#####.#.#.#####.#.#####.#.#.#.####?
#.# #.#.#...#.......#...#.....#...#...#.#.#.....#
#.###.#.#################.####?##.#.###.#.#####.#
#.....#.........#.......#.....# #...# #.#.. #...#
?##############.#.#####.###.#.#.#####.#.#####.#.#
#...#........ #...#.. #...# #.#.. #...#.......#.#
#.#.#.###.#########.#####.###.#.###.#.#########.#
#.#.#.# #...............#.#...#.#...#..... ???#.#
#.#.#.#.#########.#####.#.#.###.#.#######.#???#.#
#.#.#.#...# #...#.... #.#...#...#.....#?#.#???#.#
#.#.#.#.#.#.#.#.#######.#####.#.#####.#?#.##?##.#
#.# #.#.#...#.#......R... #...#.. #...#?#...#...#
#.###.#.###.#.#######.#####.#.#####.##???##.#.##?
#...#.#...#.#.....# ..#.....#.....#.#?????#...#??
#.#.#.#.#.#.#####.#####.####?####.#.#??????###???
#.#...#.#.#.# ..#.....#...#?????#...#????????????
#.#####.#.#.###.#####.###.##?????###?????????????
#.# ....#.#.......#... ?#...#????????????????????
#.#######.#######.#.####?##.#????????????????????
#.#.....#.......# #.....#...#????????????????????
#.#.###.#.#####.#######.#.##?????????????????????
#.#...#.# #.....#.......#.#??????????????????????
#.###.#.###.#.###.##### #.#??????????????????????
#.....#...#.# #...#?????#.#??????????????????????
?########.#.###.##??????#.#??????????????????????
#...#...#.#.#...#???????#.#??????????????????????
#.#.#.#.#.#.#.###########.#??????????????????????
#.#...#.....#............. ??????????????????????
?#?###?#####?#############???????????????????????