##?#############?#?###?###?#####?????????????????
A.#.............#.#...#...#.....#????????????????
#.#.#####.###.#.#.#.#.#.#.#.#.#.#????????????????
#.#.#...#.# #.#...#.#.#.#...#.#.#????????????????
#.#.#.#.#.#.#.#####.#.#.#####.#.##???????????????
#.# #.#.#...#.......#...#.....#...# ?????????????
#.###.#.#################.####?##.#R#????????????
#.....#.........#.......#.....#?#...#????????????
?#####?########.#.#####.###.#.#??###?????????????
??????????????#...#???#...# #.#??????????????????
???????????????###?????##.###.#??????????????????
????????????????????????#.#...#??????????????????
????????????????????????#.#.##???????????????????
????????????????????????#...#????????????????????
?????????????????????????###?????????????????????
?????????????????????????????????????????????????
?????????????????????????????????????????????????
?????????????????????????????????????????????????
?????????????????????????????????????????????????
?????????????????????????????????????????????????
?????????????????????????????????????????????????
?????????????????????????????????????????????????
?????????????????????????????????????????????????
?????????????????????????????????????????????????
?????????????????????????????????????????????????
?????????????????????????????????????????????????
?????????????????????????????????????????????????
?????????????????????????????????????????????????
?????????????????????????????????????????????????
?????????????????????????????????????????????????
?????????????????????????????????????????????????
?????????????????????????????????????????????????
?????????????????????????????????????????????????