##?#############?#?###?###?#####?#######?#######?
A.#.............#.#...#...#.....#.......#.......#
#.#.#####.###.#.#.#.#.#.#.#.#.#.#.###.#.#.#####.#
#.#.#...#.# #.#...#.#.#.#...#.#.#.. #.#.#.#.....#
#.#.#.#.#.#.#.#####.#.#.#####.#.#####.#.#.#.####?
#.# #.#.#...#.......#...#.....#...#...#.#.#.....#
#.###.#.#################.####?##.#.###.#.#####.#
#.....#.........#.......#.....# #...# #.#.. #...#
?##############.#.#####.###.#.#.#####.#.#####.#.#
#...#..... ???#...#.. #...# #.#.. #...#.......#.#
#.#.#.###.#########.#####.###.#.###.#.#########.#
#.#.#.#?#...............#.#...#.#...#..... ???#.#
#.#.#.#??########.#####.#.#.###.#.#######.#???#.#
#.#.#.#?????#...#.... #.#...#...#.....#?#.#???#.#
#.#.#.#?????#.#.#######.#####.#.#####.#?#.##?##.#
#.# #.#?????#.#......... ?#...#.. #...#?#...#...#
#.###.#?????#.#######.#####.#.#####.##???##.#.##?
#...#.#?????#.....# ..#.....#.....#.#?????#...#??
#.#.#.#??????####.#####.####?####.#.#??????###???
#.#...#?????????#.....#...#?????#...#????????????
#.####???????????####.###.##?????###?????????????
#.#???????????????#... ?#...#????????????????????
#.######??????????#.####?##.#????????????????????
#.#.....#?????????#.....#...#????????????????????
#.#.###.#????????######.#.##?????????????????????
#.#...#.#???????#.......#.#??????????????????????
#.###.#.##?????##.##### #.#??????????????????????
#.....#...#???#...#?????#.#??????????????????????
?#####?##.#??##.##??????#.#??????????????????????
????????#.#?#...#???????#.#??????????????????????
????????#.#?#.###########.#??????????????????????
??????? R. ?#............. ??????????????????????
????????##???#############???????????????????????