##?#############?#?###?###?#####?#######?#######?
A.#.............#.#...#...#.....#.......#.......#
#.#.#####.###.#.#.#.#.#.#.#.#.#.#.###.#.#.#####.#
#.#.#...#.# #.#...#.#.#.#...#.#.#.. #.#.#.#.....#
#.#.#.#.#.#.#.#####.#.#.#####.#.#####.#.#.#.####?
#.# #.#.#...#.......#...#.....#...#...#.#.#.....#
#.###.#.#################.####?##.#.###.#.#####.#
#.....#.........#.......#.....#?#...# #.#.. #...#
?#####?########.#.#####.###.#.#??####.#.#####.#.#
??????????????#...#???#...# #.#???#...#.......#.#
???????????????###?????##.###.#??##.#.#########.#
????????????????????????#.#...#?#...#..... ???#.#
????????????????????????#.#.##??#.#######.#???#.#
????????????????????????#...#???#.....#?#.#???#.#
?????????????????????????###?????####.#?#.##?##.#
??????????????????????????????????#...#?#...#...#
?????????????????????????????????##.##???##.#.##?
???????????????????????????????? R#.#?????#...#??
????????????????????????????????#.#.#??????###???
????????????????????????????????#...#????????????
?????????????????????????????????###?????????????
?????????????????????????????????????????????????
?????????????????????????????????????????????????
?????????????????????????????????????????????????
?????????????????????????????????????????????????
?????????????????????????????????????????????????
?????????????????????????????????????????????????
?????????????????????????????????????????????????
?????????????????????????????????????????????????
?????????????????????????????????????????????????
?????????????????????????????????????????????????
?????????????????????????????????????????????????
?????????????????????????????????????????????????