##???????????????????????????????????????????????
A.#??????????????????????????????????????????????
#.#??###?????????????????????????????????????????
#.#?#...#????????????????????????????????????????
#.#?#.#.#????????????????????????????????????????
#.#?#.#.#????????????????????????????????????????
#.###.#.########?#######????##???????????????????
#.....#.........#.......#?? R.#??????????????????
?#####?########.#.#####.##??#.#??????????????????
??????????????#...#???#...#?#.#??????????????????
???????????????###?????##.###.#??????????????????
????????????????????????#.#...#??????????????????
????????????????????????#.#.##???????????????????
????????????????????????#...#????????????????????
?????????????????????????###?????????????????????
?????????????????????????????????????????????????
?????????????????????????????????????????????????
?????????????????????????????????????????????????
?????????????????????????????????????????????????
?????????????????????????????????????????????????
?????????????????????????????????????????????????
?????????????????????????????????????????????????
?????????????????????????????????????????????????
?????????????????????????????????????????????????
?????????????????????????????????????????????????
?????????????????????????????????????????????????
?????????????????????????????????????????????????
?????????????????????????????????????????????????
?????????????????????????????????????????????????
?????????????????????????????????????????????????
?????????????????????????????????????????????????
?????????????????????????????????????????????????
?????????????????????????????????????????????????