##?#############?#?###?###?#####?#######?#######?
A.#.............#.#...#...#.....#.......#.......#
#.#.#####.###.#.#.#.#.#.#.#.#.#.#.###.#.#.#####.#
#.#.#...#.# #.#...#.#.#.#...#.#.#.. #.#.#.#.....#
#.#.#.#.#.#.#.#####.#.#.#####.#.#####.#.#.#.####?
#.# #.#.#...#.......#...#.....#...#...#.#.#.....#
#.###.#.#################.####?##.#.###.#.#####.#
#.....#.........#.......#.....# #...# #.#.. #...#
?#####?########.#.#####.###.#.#.#####.#.#####.#.#
??????????????#...#???#...# #.#.. #...#.......#.#
???????????????###?????##.###.#.###.#.#########.#
????????????????????????#.#...#.#...#..... ???#.#
????????????????????????#.#.###.#.#######.#???#.#
????????????????????????#...#...#.....#?#.#???#.#
?????????????????????????####.#.#####.#?#.##?##.#
??????????????????????????#...#.. #...#?#...#...#
???????????????????????####.#.#####.##???##.#.##?
??????????????????????#.....#.....#.#?????#...#??
??????????????????????#.####?####.#.#??????###???
??????????????????????#...#?????#...#????????????
???????????????????##??##.##?????###?????????????
??????????????????#.R ??#...#????????????????????
??????????????????#.####?##.#????????????????????
??????????????????#.....#...#????????????????????
?????????????????######.#.##?????????????????????
????????????????#.......#.#??????????????????????
???????????????##.##### #.#??????????????????????
??????????????#...#?????#.#??????????????????????
?????????????##.##??????#.#??????????????????????
????????????#...#???????#.#??????????????????????
????????????#.###########.#??????????????????????
????????????#............. ??????????????????????
?????????????#############???????????????????????