##?#############?#?###?###?#####?#######?#######?
A.#.............#.#...#...#.....#.......#.......#
#.#.#####.###.#.#.#.#.#.#.#.#.#.#.###.#.#.#####.#
#.#.#...#.# #.#...#.#.#.#...#.#.#.. #.#.#.#.....#
#.#.#.#.#.#.#.#####.#.#.#####.#.#####.#.#.#.####?
#.# #.#.#...#.......#...#.....#...#...#.#.#.....#
#.###.#.#################.####?##.#.###.#.#####.#
#.....#.........#.......#.....# #...# #.#.. #...#
?##############.#.#####.###.#.#.#####.#.#####.#.#
#...#........ #...#.. #...# #.#.. #...#.......#.#
#.#.#.###.#########.#####.###.#.###.#.#########.#
#.#.#.# #...............#.#...#.#...#..... ???#.#
#.#.#.#.#########.#####.#.#.###.#.#######.#???#.#
#.#.#.#...# #...#.... #.#...#...#.....# #.#???#.#
#.#.#.#.#.#.#.#.#######.#####.#.#####.#.#.##?##.#
#.# #.#.#...#.#.......... #...#.. #...#.#...#...#
#.###.#.###.#.#######.#####.#.#####.###.###.#.##?
#...#.#...#.#.....# ..#.....#.....#.#? R ?#...#??
#.#.#.#.#.#.#####.#####.#########.#.#?#.#??###???
#.#...#.#.#.# ..#.....#...# ... #...#?#.#????????
#.#####.#.#.###.#####.###.###.#########.#????????
#.# ....#.#.......#.... #...#.... #.....#????????
#.#######.#######.#.####?##.###.###.#.##?????????
#.#.....#.......# #.....#...#...#...#.#??????????
#.#.###.#.#####.#######.#.###.###.###.#??????????
#.#...#.# #.....#.......#.# #...#...#.#??????????
#.###.#.###.#.###.#####.#.#.#.#.###.#.#??????????
#.....#...#.# #...#.....#.#...#.....#.#??????????
?########.#.###.###.#####.####?######.#??????????
#...#...#.#.#...# ..... #.#...#.......#??????????
#.#.#.#.#.#.#.###########.#.#.#.######???????????
#.#...#.....#...............#...#????????????????
?#?###?#####?###############?###?????????????????