##?#############?#?###?###?#####?#######?#######?
A.#.............#.#...#...#.....#.......#.......#
#.#.#####.###.#.#.#.#.#.#.#.#.#.#.###.#.#.#####.#
#.#.#...#.# #.#...#.#.#.#...#.#.#.. #.#.#.#.....#
#.#.#.#.#.#.#.#####.#.#.#####.#.#####.#.#.#.####?
#.# #.#.#...#.......#...#.....#...#...#.#.#.....#
#.###.#.#################.####?##.#.###.#.#####.#
#.....#.........#.......#.....# #...# #.#.. #...#
?##############.#.#####.###.#.#.#####.#.#####.#.#
#...#..... ???#...#.. #...# #.#.. #...#.......#.#
#.#.#.###.#########.#####.###.#.###.#.#########.#
#.#.#.# #...............#.#...#.#...#..... ???#.#
#.#.#.#.#########.#####.#.#.###.#.#######.#???#.#
#.#.#.#...# #...#.... #.#...#...#.....#?#.#???#.#
#.#.#.#.#.#.#.#.#######.#####.#.#####.#?#.##?##.#
#.# #.#.#...#.#......... ?#...#.. #...#?#...#...#
#.###.#.###.#.#######.#####.#.#####.##???##.#.##?
#...#.#...#.#.....# ..#.....#.....#.#?????#...#??
#.#.#.# #.#.#####.#####.####?####.#.#??????###???
#.#...#?#.#.# ..#.....#...#?????#...#????????????
#.####??#.#R###.#####.###.##?????###?????????????
#.#?????#.#.......#... ?#...#????????????????????
#.#######.#######.#.####?##.#????????????????????
#.#.....#.......# #.....#...#????????????????????
#.#.###.# #####.#######.#.##?????????????????????
#.#...#.#?#.....#.......#.#??????????????????????
#.###.#.###.#.###.##### #.#??????????????????????
#.....#...#.# #...#?????#.#??????????????????????
?########.#.###.##??????#.#??????????????????????
#...#...#.#.#...#???????#.#??????????????????????
#.#.#.#.#.#.#.###########.#??????????????????????
#.#...#.....#............. ??????????????????????
?#?###?#####?#############???????????????????????