##?#############?#?###?###?#####?#######?????????
A.#.............#.#...#...#.....#.......#????????
#.#.#####.###.#.#.#.#.#.#.#.#.#.#.###.#.#????????
#.#.#...#.# #.#...#.#.#.#...#.#.#.. #.#.#????????
#.#.#.#.#.#.#.#####.#.#.#####.#.#####.#.#????????
#.# #.#.#...#.......#...#.....#...#...#.#????????
#.###.#.#################.####?##.#.###.#????????
#.....#.........#.......#.....#?#...#?#.#????????
?#####?########.#.#####.###.#.#??###??#.#####????
??????????????#...#???#...# #.#???????#.....R ???
???????????????###?????##.###.#????????######????
????????????????????????#.#...#??????????????????
????????????????????????#.#.##???????????????????
????????????????????????#...#????????????????????
?????????????????????????###?????????????????????
?????????????????????????????????????????????????
?????????????????????????????????????????????????
?????????????????????????????????????????????????
?????????????????????????????????????????????????
?????????????????????????????????????????????????
?????????????????????????????????????????????????
?????????????????????????????????????????????????
?????????????????????????????????????????????????
?????????????????????????????????????????????????
?????????????????????????????????????????????????
?????????????????????????????????????????????????
?????????????????????????????????????????????????
?????????????????????????????????????????????????
?????????????????????????????????????????????????
?????????????????????????????????????????????????
?????????????????????????????????????????????????
?????????????????????????????????????????????????
?????????????????????????????????????????????????