##???????????????????????????????????????????????
A.#??????????????????????????????????????????????
#.#??###?????????????????????????????????????????
#.#?#...#????????????????????????????????????????
#.#?#.#.#????????????????????????????????????????
#.#?#.#.#????????????????????????????????????????
#.###.#.########?###?????????????????????????????
#.....#.........#..R ????????????????????????????
?#####?########.#.##?????????????????????????????
??????????????#...#??????????????????????????????
???????????????###???????????????????????????????
?????????????????????????????????????????????????
?????????????????????????????????????????????????
?????????????????????????????????????????????????
?????????????????????????????????????????????????
?????????????????????????????????????????????????
?????????????????????????????????????????????????
?????????????????????????????????????????????????
?????????????????????????????????????????????????
?????????????????????????????????????????????????
?????????????????????????????????????????????????
?????????????????????????????????????????????????
?????????????????????????????????????????????????
?????????????????????????????????????????????????
?????????????????????????????????????????????????
?????????????????????????????????????????????????
?????????????????????????????????????????????????
?????????????????????????????????????????????????
?????????????????????????????????????????????????
?????????????????????????????????????????????????
?????????????????????????????????????????????????
?????????????????????????????????????????????????
?????????????????????????????????????????????????