##?#############?#?###?###?#####?#######?#######?
A.#.............#.#...#...#.....#.......#.......#
#.#.#####.###.#.#.#.#.#.#.#.#.#.#.###.#.#.#####.#
#.#.#...#.# #.#...#.#.#.#...#.#.#.. #.#.#.#.....#
#.#.#.#.#.#.#.#####.#.#.#####.#.#####.#.#.#.####?
#.# #.#.#...#.......#...#.....#...#...#.#.#.....#
#.###.#.#################.####?##.#.###.#.#####.#
#.....#.........#.......#.....# #...# #.#.. #...#
?##############.#.#####.###.#.#.#####.#.#####.#.#
#...#..... ???#...#.. #...# #.#.. #...#.......#.#
#.#.#.###.#########.#####.###.#.###.#.#########.#
#.#.#.#?#...............#.#...#.#...#..... ???#.#
#.#.#.#??########.#####.#.#.###.#.#######.#???#.#
#.#.#.#?????#...#.... #.#...#...#.....#?#.#???#.#
#.#.#.#?????#.#.#######.#####.#.#####.#?#.##?##.#
#.# #.#?????#.#......... ?#...#.. #...#?#...#...#
#.###.#?????#.#######.#####.#.#####.##???##.#.##?
#...#.#?????#.....# ..#.....#.....#.#?????#...#??
#.#.#.#??????####.#####.####?####.#.#??????###???
#.#...#?????????#.....#...#?????#...#????????????
#.####???????????####.###.##?????###?????????????
#.#???????????????#... ?#...#????????????????????
#.#???????????????#.####?##.#????????????????????
#.#???????????????#.....#...#????????????????????
#.#??????????????######.#.##?????????????????????
#.#?? ??????????#.......#.#??????????????????????
#.###R#????????##.##### #.#??????????????????????
#.....#???????#...#?????#.#??????????????????????
?#####???????##.##??????#.#??????????????????????
????????????#...#???????#.#??????????????????????
????????????#.###########.#??????????????????????
????????????#............. ??????????????????????
?????????????#############???????????????????????