##?#############?#?###?###?#####?#######?#######?
A.#.............#.#...#...#.....#.......#.......#
#.#.#####.###.#.#.#.#.#.#.#.#.#.#.###.#.#.#####.#
#.#.#...#.# #.#...#.#.#.#...#.#.#.. #.#.#.#.....#
#.#.#.#.#.#.#.#####.#.#.#####.#.#####.#.#.#.####?
#.# #.#.#...#.......#...#.....#...#...#.#.#.....#
#.###.#.#################.####?##.#.###.#.#####.#
#.....#.........#.......#.....# #...# #.#.. #...#
?##############.#.#####.###.#.#.#####.#.#####.#.#
#...#........ #...#.. #...# #.#.. #...#.......#.#
#.#.#.###.#########.#####.###.#.###.#.#########.#
#.#.#.# #...............#.#...#.#...#..... ???#.#
#.#.#.#.#########.#####.#.#.###.#.#######.#???#.#
#.#.#.#...# #...#.... #.#...#...#.....#?#.#???#.#
#.#.#.#.#.#.#.#.#######.#####.#.#####.#?#.##?##.#
#.# #.#.#...#.#.......... #...#.. #...#?#...#...#
#.###.#.###.#.#######.#####.#.#####.##???##.#.##?
#...#.#...#.#.....# ..#.....#.....#.#?????#...#??
#.#.#.#.#.#.#####.#####.####?####.#.#??????###???
#.#...#.#.#.# ..#.....#...#?????#...#????????????
#.#####.#.#.###.#####.###.##?????#####???????????
#.# ....#.#.......#.... #...#?????#... ??????????
#.#######.#######.#.####?##.#????##.#.#??????????
#.#.....#.......# #.....#...#???#...#.#??????????
#.#.###.#.#####.#######.#.##????#R###.#??????????
#.#...#.# #.....#.......#.#?????? ??#.#??????????
#.###.#.###.#.###.#####.#.#?????????#.#??????????
#.....#...#.# #...#.....#.#?????????#.#??????????
?########.#.###.###.#####.####?######.#??????????
#...#...#.#.#...# ..... #.#...#.......#??????????
#.#.#.#.#.#.#.###########.#.#.#.######???????????
#.#...#.....#...............#...#????????????????
?#?###?#####?###############?###?????????????????