##?#############?#?###?###?#####?#######?#######?
A.#.............#.#...#...#.....#.......#.......#
#.#.#####.###.#.#.#.#.#.#.#.#.#.#.###.#.#.#####.#
#.#.#...#.# #.#...#.#.#.#...#.#.#.. #.#.#R#.....#
#.#.#.#.#.#.#.#####.#.#.#####.#.#####.#.#.#.####?
#.# #.#.#...#.......#...#.....#...#...#.#.#.....#
#.###.#.#################.####?##.#.###.#.#####.#
#.....#.........#.......#.....#?#...#?#.#.. #...#
?#####?########.#.#####.###.#.#??###??#.#####.# ?
??????????????#...#???#...# #.#???????#.......#??
???????????????###?????##.###.#????????#######???
????????????????????????#.#...#??????????????????
????????????????????????#.#.##???????????????????
????????????????????????#...#????????????????????
?????????????????????????###?????????????????????
?????????????????????????????????????????????????
?????????????????????????????????????????????????
?????????????????????????????????????????????????
?????????????????????????????????????????????????
?????????????????????????????????????????????????
?????????????????????????????????????????????????
?????????????????????????????????????????????????
?????????????????????????????????????????????????
?????????????????????????????????????????????????
?????????????????????????????????????????????????
?????????????????????????????????????????????????
?????????????????????????????????????????????????
?????????????????????????????????????????????????
?????????????????????????????????????????????????
?????????????????????????????????????????????????
?????????????????????????????????????????????????
?????????????????????????????????????????????????
?????????????????????????????????????????????????