##?#############?#?###?###?#####?#######?#######?
A.#.............#.#...#...#.....#.......#.......#
#.#.#####.###.#.#.#.#.#.#.#.#.#.#.###.#.#.#####.#
#.#.#...#.# #.#...#.#.#.#...#.#.#.. #.#.#.#.....#
#.#.#.#.#.#.#.#####.#.#.#####.#.#####.#.#.#.####?
#.# #.#.#...#.......#...#.....#...#...#.#.#.....#
#.###.#.#################.####?##.#.###.#.#####.#
#.....#.........#.......#.....#?#...# #.#.. #...#
?#####?########.#.#####.###.#.# ?####.#.#####.#.#
??????????????#...#???#...# #.#R ?#...#.......#.#
???????????????###?????##.###.#.###.#.#########.#
????????????????????????#.#...#.#...#..... ???#.#
????????????????????????#.#.###.#.#######.#???#.#
????????????????????????#...#...#.....#?#.#???#.#
?????????????????????????####.# ?####.#?#.##?##.#
???????????????????????????? .#???#...#?#...#...#
????????????????????????????#.#####.##???##.#.##?
????????????????????????????#.....#.#?????#...#??
?????????????????????????????####.#.#??????###???
????????????????????????????????#...#????????????
?????????????????????????????????###?????????????
?????????????????????????????????????????????????
?????????????????????????????????????????????????
?????????????????????????????????????????????????
?????????????????????????????????????????????????
?????????????????????????????????????????????????
?????????????????????????????????????????????????
?????????????????????????????????????????????????
?????????????????????????????????????????????????
?????????????????????????????????????????????????
?????????????????????????????????????????????????
?????????????????????????????????????????????????
?????????????????????????????????????????????????