##?#############?#?###?###?#####?????????????????
A.#.............#.#...#...#.....#????????????????
#.#.#####.###.#.#.#.#.#.#.#.#.#.#????????????????
#.#.#...#.# #.#...#.#.#.#...#.#.#????????????????
#.#.#.#.#.#.#.#####.#.#.#####.#R#????????????????
#.# #.#.#...#.......#...#.....# ?????????????????
#.###.#.#################.####???????????????????
#.....#.........#.......#.....#??????????????????
?#####?########.#.#####.###.#.#??????????????????
??????????????#...#???#...# #.#??????????????????
???????????????###?????##.###.#??????????????????
????????????????????????#.#...#??????????????????
????????????????????????#.#.##???????????????????
????????????????????????#...#????????????????????
?????????????????????????###?????????????????????
?????????????????????????????????????????????????
?????????????????????????????????????????????????
?????????????????????????????????????????????????
?????????????????????????????????????????????????
?????????????????????????????????????????????????
?????????????????????????????????????????????????
?????????????????????????????????????????????????
?????????????????????????????????????????????????
?????????????????????????????????????????????????
?????????????????????????????????????????????????
?????????????????????????????????????????????????
?????????????????????????????????????????????????
?????????????????????????????????????????????????
?????????????????????????????????????????????????
?????????????????????????????????????????????????
?????????????????????????????????????????????????
?????????????????????????????????????????????????
?????????????????????????????????????????????????