##?#############?#?###?###?#####?#######?#######?
A.#.............#.#...#...#.....#.......#.......#
#.#.#####.###.#.#.#.#.#.#.#.#.#.#.###.#.#.#####.#
#.#.#...#.# #.#...#.#.#.#...#.#.#.. #.#.#.#.....#
#.#.#.#.#.#.#.#####.#.#.#####.#.#####.#.#.#.####?
#.# #.#.#...#.......#...#.....#...#...#.#.#.....#
#.###.#.#################.####?##.#.###.#.#####.#
#.....#.........#.......#.....# #...# #.#.. #...#
?##############.#.#####.###.#.#.#####.#.#####.#.#
#...#........ #...#.. #...# #.#.. #...#.......#.#
#.#.#.###.#########.#####.###.#.###.#.#########.#
#.#.#.# #...............#.#...#.#...#..... ???#.#
#.#.#.#.#########.#####.#.#.###.#.#######.#???#.#
#.#.#.#...# #...#.... #.#...#...#.....# #.#???#.#
#.#.#.#.#.#.#.#.#######.#####.#.#####.#.#.##?##.#
#.# #.#.#...#.#.......... #...#.. #...#.#...#...#
#.###.#.###.#.#######.#####.#.#####.###.###.#.##?
#...#.#...#.#.....# ..#.....#.....#.#.....#...#.#
#.#.#.#.#.#.#####.#####.#########.#.#.#.#.#####.#
#.#...#.#.#.# ..#.....#...# ... #...# #.#.......#
#.#####.#.#.###.#####.###.###.#########.#######.#
#.# ....#.#.......#.... #...#.... #.....#.......#
#.#######.#######.#.####?##.###.###.#.###R######?
#.#.....#.......# #.....#...#...#...#.#?? ???????
#.#.###.#.#####.#######.#.###.###.###.#??????????
#.#...#.# #.....#.......#.# #...#...#.#??????????
#.###.#.###.#.###.#####.#.#.#.#.###.#.#??????????
#.....#...#.# #...#.....#.#...#.....#.#??????????
?########.#.###.###.#####.####?######.#??????????
#...#...#.#.#...# ..... #.#...#.......#??????????
#.#.#.#.#.#.#.###########.#.#.#.######???????????
#.#...#.....#...............#...#????????????????
?#?###?#####?###############?###?????????????????