##?#############?#?###?###?#####?#######?#######?
A.#.............#.#...#...#.....#.......#.......#
#.#.#####.###.#.#.#.#.#.#.#.#.#.#.###.#.#.#####.#
#.#.#...#.# #.#...#.#.#.#...#.#.#.. #.#.#.#.....#
#.#.#.#.#.#.#.#####.#.#.#####.#.#####.#.#.#.####?
#.# #.#.#...#.......#...#.....#...#...#.#.#.....#
#.###.#.#################.####?##.#.###.#.#####.#
#.....#.........#.......#.....# #...# #.#.. #...#
?#####?########.#.#####.###.#.#.#####.#.#####.#.#
??????????????#...#???#...# #.#.. #...#.......#.#
???????????????###?????##.###.#.###.#.#########.#
????????????????????????#.#...#.#...#..... ???#.#
????????????????????????#.#.###.#.#######.#???#.#
????????????????????????#...#...#.....#?#.#???#.#
?????????????????????????####.#.#####.#?#.##?##.#
??????????????????????????#...#.. #...#?#...#...#
???????????????????????####.#.#####.##???##.#.##?
??????????????????????#.....#.....#.#?????#...#??
??????????????????????#.####?####.#.#??????###???
??????????????????????#...#?????#...#????????????
???????????????????????##.##?????###?????????????
????????????????????????#...#????????????????????
?????????????????????????##.#????????????????????
????????????????????????? R.#????????????????????
??????????????????????????##?????????????????????
?????????????????????????????????????????????????
?????????????????????????????????????????????????
?????????????????????????????????????????????????
?????????????????????????????????????????????????
?????????????????????????????????????????????????
?????????????????????????????????????????????????
?????????????????????????????????????????????????
?????????????????????????????????????????????????