##?????????????????###?###?###???????????????????
A.#???????????????#R..#...#... ??????????????????
#.#??###??????????? #.#.#.#.#.#??????????????????
#.#?#...#???????????#.#.#...#.#??????????????????
#.#?#.#.#???????????#.#.#####.#??????????????????
#.#?#.#.#???????????#...#.....#??????????????????
#.###.#.########?########.####???????????????????
#.....#.........#.......#.....#??????????????????
?#####?########.#.#####.###.#.#??????????????????
??????????????#...#???#...# #.#??????????????????
???????????????###?????##.###.#??????????????????
????????????????????????#.#...#??????????????????
????????????????????????#.#.##???????????????????
????????????????????????#...#????????????????????
?????????????????????????###?????????????????????
?????????????????????????????????????????????????
?????????????????????????????????????????????????
?????????????????????????????????????????????????
?????????????????????????????????????????????????
?????????????????????????????????????????????????
?????????????????????????????????????????????????
?????????????????????????????????????????????????
?????????????????????????????????????????????????
?????????????????????????????????????????????????
?????????????????????????????????????????????????
?????????????????????????????????????????????????
?????????????????????????????????????????????????
?????????????????????????????????????????????????
?????????????????????????????????????????????????
?????????????????????????????????????????????????
?????????????????????????????????????????????????
?????????????????????????????????????????????????
?????????????????????????????????????????????????