##?#############?#?###?###?#####?#######?#######?
A.#.............#.#...#...#.....#.......#.......#
#.#.#####.###.#.#.#.#.#.#.#.#.#.#.###.#.#.#####.#
#.#.#...#.# #.#...#.#.#.#...#.#.#.. #.#.#.#.....#
#.#.#.#.#.#.#.#####.#.#.#####.#.#####.#.#.#.####?
#.# #.#.#...#.......#...#.....#...#...#.#.#.....#
#.###.#.#################.####?##.#.###.#.#####.#
#.....#.........#.......#.....# #...# #.#.. #...#
?##############.#.#####.###.#.#.#####.#.#####.#.#
#.R #..... ???#...#.. #...# #.#.. #...#.......#.#
#.#?#.###.#########.#####.###.#.###.#.#########.#
#.#?#.#?#...............#.#...#.#...#..... ???#.#
#.#?#.#??########.#####.#.#.###.#.#######.#???#.#
#.#?#.#?????#...#.... #.#...#...#.....#?#.#???#.#
#.#?#.#?????#.#.#######.#####.#.#####.#?#.##?##.#
#.#?#.#?????#.#......... ?#...#.. #...#?#...#...#
#.###.#?????#.#######.#####.#.#####.##???##.#.##?
#...#.#?????#.....# ..#.....#.....#.#?????#...#??
? #.#.#??????####.#####.####?####.#.#??????###???
??#...#?????????#.....#...#?????#...#????????????
???###???????????####.###.##?????###?????????????
??????????????????#... ?#...#????????????????????
??????????????????#.####?##.#????????????????????
??????????????????#.....#...#????????????????????
?????????????????######.#.##?????????????????????
????????????????#.......#.#??????????????????????
???????????????##.##### #.#??????????????????????
??????????????#...#?????#.#??????????????????????
?????????????##.##??????#.#??????????????????????
????????????#...#???????#.#??????????????????????
????????????#.###########.#??????????????????????
????????????#............. ??????????????????????
?????????????#############???????????????????????