##?#############?#?###?###?#####?#######?#######?
A.#.............#.#...#...#.....#.......#.......#
#.#.#####.###.#.#.#.#.#.#.#.#.#.#.###.#.#.#####.#
#.#.#...#.# #.#...#.#.#.#...#.#.#.. #.#.#.#.....#
#.#.#.#.#.#.#.#####.#.#.#####.#.#####.#.#.#.####?
#.# #.#.#...#.......#...#.....#...#...#.#.#.....#
#.###.#.#################.####?##.#.###.#.#####.#
#.....#.........#.......#.....#?#...# #.#.. #...#
?#####?########.#.#####.###.#.#??####.#.#####.#.#
??????????????#...#???#...# #.#???#...#.......#.#
???????????????###?????##.###.#??##.#.#########.#
????????????????????????#.#...#?#...#..... ???#.#
????????????????????????#.#.##??#.#######.#???#.#
????????????????????????#...#???#.....#?#.#???#.#
?????????????????????????###?????####.#?#.##?##.#
??????????????????????????????????#...#?#...#...#
??????????????????????????????????#.##???##.#.##?
??????????????????????????????????#.#?????#...#??
??????????????????????????????????#.#??????###???
?????????????????????????????????? R#????????????
???????????????????????????????????#?????????????
?????????????????????????????????????????????????
?????????????????????????????????????????????????
?????????????????????????????????????????????????
?????????????????????????????????????????????????
?????????????????????????????????????????????????
?????????????????????????????????????????????????
?????????????????????????????????????????????????
?????????????????????????????????????????????????
?????????????????????????????????????????????????
?????????????????????????????????????????????????
?????????????????????????????????????????????????
?????????????????????????????????????????????????