##?#############?#?###?###?#####?#######?#######?
A.#.............#.#...#...#.....#.......#.......#
#.#.#####.###.#.#.#.#.#.#.#.#.#.#.###.#.#.#####.#
#.#.#...#.# #.#...#.#.#.#...#.#.#.. #.#.#.#.....#
#.#.#.#.#.#.#.#####.#.#.#####.#.#####.#.#.#.####?
#.# #.#.#...#.......#...#.....#...#...#.#.#.....#
#.###.#.#################.####?##.#.###.#.#####.#
#.....#.........#.......#.....# #...# #.#.. #...#
?##############.#.#####.###.#.#.#####.#.#####.#.#
#...#........ #...#.. #...# #.#.. #...#.......#.#
#.#.#.###.#########.#####.###.#.###.#.#########.#
#.#.#.# #...............#.#...#.#...#..... ???#.#
#.#.#.#.#########.#####.#.#.###.#.#######.#???#.#
#.#.#.#...# #...#.... #.#...#...#.....#?#.#???#.#
#.#.#.#.#.#.#.#.#######.#####.#.#####.#?#.##?##.#
#.# #.#.#...#.#.......... #...#.. #...#?#...#...#
#.###.#.###.#.#######.#####.#.#####.##???##.#.##?
#...#.#...#.#.....# ..#.....#.....#.#?????#...#??
#.#.#.#.#.#.#####.#####.#########.#.#??????###???
#.#...#.#.#.# ..#.....#...# ..R #...#????????????
#.#####.#.#.###.#####.###.###.##?#####???????????
#.# ....#.#.......#.... #...#... ?#... ??????????
#.#######.#######.#.####?##.###.###.#.#??????????
#.#.....#.......# #.....#...#...#...#.#??????????
#.#.###.#.#####.#######.#.###.###.###.#??????????
#.#...#.# #.....#.......#.#?#...#...#.#??????????
#.###.#.###.#.###.#####.#.#?? #.###.#.#??????????
#.....#...#.# #...#.....#.#???#.....#.#??????????
?########.#.###.###.#####.####?######.#??????????
#...#...#.#.#...# ..... #.#...#.......#??????????
#.#.#.#.#.#.#.###########.#.#.#.######???????????
#.#...#.....#...............#...#????????????????
?#?###?#####?###############?###?????????????????