##?#############?#?###?###?#####?#######?????###?
A.#.............#.#...#...#.....#.......#??? R..#
#.#.#####.###.#.#.#.#.#.#.#.#.#.#.###.#.#??####.#
#.#.#...#.# #.#...#.#.#.#...#.#.#.. #.#.#?#.....#
#.#.#.#.#.#.#.#####.#.#.#####.#.#####.#.#?#.####?
#.# #.#.#...#.......#...#.....#...#...#.#?#.....#
#.###.#.#################.####?##.#.###.#??####.#
#.....#.........#.......#.....#?#...#?#.#???#...#
?#####?########.#.#####.###.#.#??###??#.#####.# ?
??????????????#...#???#...# #.#???????#.......#??
???????????????###?????##.###.#????????#######???
????????????????????????#.#...#??????????????????
????????????????????????#.#.##???????????????????
????????????????????????#...#????????????????????
?????????????????????????###?????????????????????
?????????????????????????????????????????????????
?????????????????????????????????????????????????
?????????????????????????????????????????????????
?????????????????????????????????????????????????
?????????????????????????????????????????????????
?????????????????????????????????????????????????
?????????????????????????????????????????????????
?????????????????????????????????????????????????
?????????????????????????????????????????????????
?????????????????????????????????????????????????
?????????????????????????????????????????????????
?????????????????????????????????????????????????
?????????????????????????????????????????????????
?????????????????????????????????????????????????
?????????????????????????????????????????????????
?????????????????????????????????????????????????
?????????????????????????????????????????????????
?????????????????????????????????????????????????