##?#############?#?###?###?#####?#######?#######?
A.#.............#.#...#...#.....#.......#.......#
#.#.#####.###.#.#.#.#.#.#.#.#.#.#.###.#.#.#####.#
#.#.#...#.# #.#...#.#.#.#...#.#.#.. #.#.#.#.....#
#.#.#.#.#.#.#.#####.#.#.#####.#.#####.#.#.#.####?
#.# #.#.#...#.......#...#.....#...#...#.#.#.....#
#.###.#.#################.####?##.#.###.#.#####.#
#.....#.........#.......#.....# #...# #.#.. #...#
?##############.#.#####.###.#.#.#####.#.#####.#.#
#...#..... ???#...#.. #...# #.#.. #...#.......#.#
#.#.#.###.#########.#####.###.#.###.#.#########.#
#.#.#.#?#...............#.#...#.#...#..... ???#.#
#.#.#.#??########.#####.#.#.###.#.#######.#???#.#
#.#.#.#?????#...#.... #.#...#...#.....#?#.#???#.#
#.#.#.#?????#.#.#######.#####.#.#####.#?#.##?##.#
#.# #.#?????#.#......... ?#...#.. #...#?#...#...#
#.###.#?????#.#######.#####.#.#####.##???##.#.##?
#...#.#?????#.....# ..#.....#.....#.#?????#...#??
#.#.#.#??????####.#####.####?####.#.#??????###???
#.#...#?????????#.....#...#?????#...#????????????
#.####???????????####.###.##?????###?????????????
#.#???????????????#... ?#...#????????????????????
#.######????####??#.####?##.#????????????????????
#.#.....#?? R...#?#.....#...#????????????????????
#.#.###.#??####.#######.#.##?????????????????????
#.#...#.#?#.....#.......#.#??????????????????????
#.###.#.###.#.###.##### #.#??????????????????????
#.....#...#.# #...#?????#.#??????????????????????
?########.#.###.##??????#.#??????????????????????
#...#...#.#.#...#???????#.#??????????????????????
#.#.#.#.#.#.#.###########.#??????????????????????
#.#...#.....#............. ??????????????????????
?#?###?#####?#############???????????????????????