##?#############?#?###?###?#####?#######?#######?
A.#.............#.#...#...#.....#.......#.......#
#.#.#####.###.#.#.#.#.#.#.#.#.#.#.###.#.#.#####.#
#.#.#...#.# #.#...#.#.#.#...#.#.#.. #.#.#.#.....#
#.#.#.#.#.#.#.#####.#.#.#####.#.#####.#.#.#.####?
#.# #.#.#...#.......#...#.....#...#...#.#.#.....#
#.###.#.#################.####?##.#.###.#.#####.#
#.....#.........#.......#.....# #...# #.#.. #...#
?##############.#.#####.###.#.#.#####.#.#####.#.#
#R..#..... ???#...#.. #...# #.#.. #...#.......#.#
#.#.#.###.#########.#####.###.#.###.#.#########.#
#.#.#.#?#...............#.#...#.#...#..... ???#.#
#.#.#.#??########.#####.#.#.###.#.#######.#???#.#
#.#.#.#?????#...#.... #.#...#...#.....#?#.#???#.#
#.#.#.#?????#.#.#######.#####.#.#####.#?#.##?##.#
#.# #.#?????#.#......... ?#...#.. #...#?#...#...#
#.###.#?????#.#######.#####.#.#####.##???##.#.##?
#...#.#?????#.....# ..#.....#.....#.#?????#...#??
? #.#.#??????####.#####.####?####.#.#??????###???
??#...#?????????#.....#...#?????#...#????????????
???###???????????####.###.##?????###?????????????
??????????????????#... ?#...#????????????????????
??????????????????#.####?##.#????????????????????
??????????????????#.....#...#????????????????????
?????????????????######.#.##?????????????????????
????????????????#.......#.#??????????????????????
???????????????##.##### #.#??????????????????????
??????????????#...#?????#.#??????????????????????
?????????????##.##??????#.#??????????????????????
????????????#...#???????#.#??????????????????????
????????????#.###########.#??????????????????????
????????????#............. ??????????????????????
?????????????#############???????????????????????