##?#############?#?###?###?#####?#######?#######?
A.#.............#.#...#...#.....#.......#.......#
#.#.#####.###.#.#.#.#.#.#.#.#.#.#.###.#.#.#####.#
#.#.#...#.# #.#...#.#.#.#...#.#.#.. #.#.#.#.....#
#.#.#.#.#.#.#.#####.#.#.#####.#.#####.#.#.#.####?
#.# #.#.#...#.......#...#.....#...#...#.#.#.....#
#.###.#.#################.####?##.#.###.#.#####.#
#.....#.........#.......#.....# #...# #.#.. #...#
?##############.#.#####.###.#.#.#####.#.#####.#.#
#...#..... ???#...#.. #...# #.#.. #...#.......#.#
#.#.#.###.#########.#####.###.#.###.#.#########.#
#.#.#.#?#...............#.#...#.#...#..... ???#.#
#.#.#.#??########.#####.#.#.###.#.#######.#???#.#
#.#.#.#?????#...#.... #.#...#...#.....#?#.#???#.#
#.#.#.#?????#.#.#######.#####.#.#####.#?#.##?##.#
#.# #.#?????#.#......... ?#...#.. #...#?#...#...#
#.###.#??#??#.#######.#####.#.#####.##???##.#.##?
#...#.#? R#?#.....# ..#.....#.....#.#?????#...#??
#.#.#.#?#.#??####.#####.####?####.#.#??????###???
#.#...#?#.#?????#.....#...#?????#...#????????????
#.####??#.#??????####.###.##?????###?????????????
#.#?????#.#???????#... ?#...#????????????????????
#.#######.######??#.####?##.#????????????????????
#.#.....#.......#?#.....#...#????????????????????
#.#.###.# #####.#######.#.##?????????????????????
#.#...#.#?#.....#.......#.#??????????????????????
#.###.#.###.#.###.##### #.#??????????????????????
#.....#...#.# #...#?????#.#??????????????????????
?########.#.###.##??????#.#??????????????????????
#...#...#.#.#...#???????#.#??????????????????????
#.#.#.#.#.#.#.###########.#??????????????????????
#.#...#.....#............. ??????????????????????
?#?###?#####?#############???????????????????????