##?#############?#?###?###?#####?????????????????
A.#.............#.#...#...#.....#????????????????
#.#.#####.###.#.#.#.#.#.#.#.#.#.#????????????????
#.#.#...#.# #.#...#.#.#.#...#.#.#????????????????
#.#.#.#.#.#.#.#####.#.#.#####.#.##???????????????
#.# #.#.#...#.......#...#.....#...#??????????????
#.###.#.#################.####?##.# ?????????????
#.....#.........#.......#.....#?#..R#????????????
?#####?########.#.#####.###.#.#??###?????????????
??????????????#...#???#...# #.#??????????????????
???????????????###?????##.###.#??????????????????
????????????????????????#.#...#??????????????????
????????????????????????#.#.##???????????????????
????????????????????????#...#????????????????????
?????????????????????????###?????????????????????
?????????????????????????????????????????????????
?????????????????????????????????????????????????
?????????????????????????????????????????????????
?????????????????????????????????????????????????
?????????????????????????????????????????????????
?????????????????????????????????????????????????
?????????????????????????????????????????????????
?????????????????????????????????????????????????
?????????????????????????????????????????????????
?????????????????????????????????????????????????
?????????????????????????????????????????????????
?????????????????????????????????????????????????
?????????????????????????????????????????????????
?????????????????????????????????????????????????
?????????????????????????????????????????????????
?????????????????????????????????????????????????
?????????????????????????????????????????????????
?????????????????????????????????????????????????