##?#############?#?###?###?#####?#######?#######?
A.#.............#.#...#...#.....#.......#.......#
#.#.#####.###.#.#.#.#.#.#.#.#.#.#.###.#.#.#####.#
#.#.#...#.# #.#...#.#.#.#...#.#.#.. #.#.#.#.....#
#.#.#.#.#.#.#.#####.#.#.#####.#.#####.#.#.#.####?
#.# #.#.#...#.......#...#.....#...#...#.#.#.....#
#.###.#.#################.####?##.#.###.#.#####.#
#.....#.........#.......#.....# #...# #.#.. #...#
?##############.#.#####.###.#.#.#####.#.#####.#.#
#...#........ #...#.. #...# #.#.. #...#.......#.#
#.#.#.###.#########.#####.###.#.###.#.#########.#
#.#.#.# #...............#.#...#.#...#..... ???#.#
#.#.#.#.#########.#####.#.#.###.#.#######.#???#.#
#.#.#.#...# #...#.... #.#...#...#.....#?#.#???#.#
#.#.#.#.#.#.#.#.#######.#####.#.#####.#?#.##?##.#
#.# #.#.#...#.#.......... #...#.. #...#?#...#...#
#.###.#.###.#.#######.#####.#.#####.##???##.#.##?
#...#.#...#.#.....# ..#.....#.....#.#?????#...#??
#.#.#.#.#.#.#####.#####.####?####.#.#??????###???
#.#...#.#.#.# ..#.....#...#?????#...#????????????
#.#####.#.#.###.#####.###.##?????###?????????????
#.# ....#.#.......#.... #...#????????????????????
#.#######.#######.#.####?##.#????????????????????
#.#.....#.......# #.....#...#????????????????????
#.#.###.#.#####.#######.#.##?????????????????????
#.#...#.# #.....#.......#.#??????????????????????
#.###.#.###.#.###.#####.#.#??????????????????????
#.....#...#.# #...#.....#.#??????????????????????
?########.#.###.###.#####.####?#####?????????????
#...#...#.#.#...# ..... #.#...#....R ????????????
#.#.#.#.#.#.#.###########.#.#.#.####?????????????
#.#...#.....#...............#...#????????????????
?#?###?#####?###############?###?????????????????