##???????????????????????????????????????????????
A.#??????????????????????????????????????????????
#.#??###?????????????????????????????????????????
#.#?#...#????????????????????????????????????????
#.#?#.#.#????????????????????????????????????????
#.#?#.#.#????????????????????????????????????????
#.###.#.########?#######?????????????????????????
#.....#.........#.......#????????????????????????
?#####?########.#.#####.##???????????????????????
??????????????#...#???#...#??????????????????????
???????????????###?????##.#??????????????????????
????????????????????????#R#??????????????????????
????????????????????????? ???????????????????????
?????????????????????????????????????????????????
?????????????????????????????????????????????????
?????????????????????????????????????????????????
?????????????????????????????????????????????????
?????????????????????????????????????????????????
?????????????????????????????????????????????????
?????????????????????????????????????????????????
?????????????????????????????????????????????????
?????????????????????????????????????????????????
?????????????????????????????????????????????????
?????????????????????????????????????????????????
?????????????????????????????????????????????????
?????????????????????????????????????????????????
?????????????????????????????????????????????????
?????????????????????????????????????????????????
?????????????????????????????????????????????????
?????????????????????????????????????????????????
?????????????????????????????????????????????????
?????????????????????????????????????????????????
?????????????????????????????????????????????????