##?#############?#?###?###?#####?????????????????
A.#.............#.#...#...#.....#????????????????
#.#.#####.###.#.#.#.#.#.#.#.#.#.#????????????????
#.#.#...#.# #.#...#.#.#.#...#.#R#????????????????
#.#.#.#.#.#.#.#####.#.#.#####.# ?????????????????
#.# #.#.#...#.......#...#.....#??????????????????
#.###.#.#################.####???????????????????
#.....#.........#.......#.....#??????????????????
?#####?########.#.#####.###.#.#??????????????????
??????????????#...#???#...# #.#??????????????????
???????????????###?????##.###.#??????????????????
????????????????????????#.#...#??????????????????
????????????????????????#.#.##???????????????????
????????????????????????#...#????????????????????
?????????????????????????###?????????????????????
?????????????????????????????????????????????????
?????????????????????????????????????????????????
?????????????????????????????????????????????????
?????????????????????????????????????????????????
?????????????????????????????????????????????????
?????????????????????????????????????????????????
?????????????????????????????????????????????????
?????????????????????????????????????????????????
?????????????????????????????????????????????????
?????????????????????????????????????????????????
?????????????????????????????????????????????????
?????????????????????????????????????????????????
?????????????????????????????????????????????????
?????????????????????????????????????????????????
?????????????????????????????????????????????????
?????????????????????????????????????????????????
?????????????????????????????????????????????????
?????????????????????????????????????????????????