##???????????????????????????????????????????????
A.#??????????????????????????????????????????????
#.#??###?????????????????????????????????????????
#.#?#...#????????????????????????????????????????
#.#?#.#.#????????????????????????????????????????
#.#?#.#.#???????????????? ???????????????????????
#.###.#.########?########R####???????????????????
#.....#.........#.......#.....#??????????????????
?#####?########.#.#####.###.#.#??????????????????
??????????????#...#???#...# #.#??????????????????
???????????????###?????##.###.#??????????????????
????????????????????????#.#...#??????????????????
????????????????????????#.#.##???????????????????
????????????????????????#...#????????????????????
?????????????????????????###?????????????????????
?????????????????????????????????????????????????
?????????????????????????????????????????????????
?????????????????????????????????????????????????
?????????????????????????????????????????????????
?????????????????????????????????????????????????
?????????????????????????????????????????????????
?????????????????????????????????????????????????
?????????????????????????????????????????????????
?????????????????????????????????????????????????
?????????????????????????????????????????????????
?????????????????????????????????????????????????
?????????????????????????????????????????????????
?????????????????????????????????????????????????
?????????????????????????????????????????????????
?????????????????????????????????????????????????
?????????????????????????????????????????????????
?????????????????????????????????????????????????
?????????????????????????????????????????????????