##?#############?#?###?###?#####?#######?#######?
A.#.............#.#...#...#.....#.......#.......#
#.#.#####.###.#.#.#.#.#.#.#.#.#.#.###.#.#.#####.#
#.#.#...#.# #.#...#.#.#.#...#.#.#.. #.#.#.#.....#
#.#.#.#.#.#.#.#####.#.#.#####.#.#####.#.#.#.####?
#.# #.#.#...#.......#...#.....#...#...#.#.#.....#
#.###.#.#################.####?##.#.###.#.#####.#
#.....#.........#.......#.....#?#...#?#.#.. #...#
?#####?########.#.#####.###.#.#??###??#.#####.#.#
??????????????#...#???#...# #.#???????#.......#.#
???????????????###?????##.###.#????????########.#
????????????????????????#.#...#???????????????#.#
????????????????????????#.#.##????????????????#R#
????????????????????????#...#?????????????????? ?
?????????????????????????###?????????????????????
?????????????????????????????????????????????????
?????????????????????????????????????????????????
?????????????????????????????????????????????????
?????????????????????????????????????????????????
?????????????????????????????????????????????????
?????????????????????????????????????????????????
?????????????????????????????????????????????????
?????????????????????????????????????????????????
?????????????????????????????????????????????????
?????????????????????????????????????????????????
?????????????????????????????????????????????????
?????????????????????????????????????????????????
?????????????????????????????????????????????????
?????????????????????????????????????????????????
?????????????????????????????????????????????????
?????????????????????????????????????????????????
?????????????????????????????????????????????????
?????????????????????????????????????????????????