##?#############?#?###?###?#####?#######?#######?
A.#.............#.#...#...#.....#.......#.......#
#.#.#####.###.#.#.#.#.#.#.#.#.#.#.###.#.#.#####.#
#.#.#...#.# #.#...#.#.#.#...#.#.#.. #.#.#.#.....#
#.#.#.#.#.#.#.#####.#.#.#####.#.#####.#.#.#.####?
#.# #.#.#...#.......#...#.....#...#...#.#.#.....#
#.###.#.#################.####?##.#.###.#.#####.#
#.....#.........#.......#.....# #...# #.#.. #...#
?##############.#.#####.###.#.#.#####.#.#####.#.#
????#..... ???#...#.. #...# #.#.. #...#.......#.#
????#.###.#########.#####.###.#.###.#.#########.#
????#.#?#...............#.#...#.#...#..... ???#.#
????#.#??########.#####.#.#.###.#.#######.#???#.#
????#.#?????#...#.... #.#...#...#.....#?#.#???#.#
????#.#?????#.#.#######.#####.#.#####.#?#.##?##.#
????#.#?????#.#......... ?#...#.. #...#?#...#...#
????#R#?????#.#######.#####.#.#####.##???##.#.##?
????? ??????#.....# ..#.....#.....#.#?????#...#??
?????????????####.#####.####?####.#.#??????###???
????????????????#.....#...#?????#...#????????????
?????????????????####.###.##?????###?????????????
??????????????????#... ?#...#????????????????????
??????????????????#.####?##.#????????????????????
??????????????????#.....#...#????????????????????
?????????????????######.#.##?????????????????????
????????????????#.......#.#??????????????????????
???????????????##.##### #.#??????????????????????
??????????????#...#?????#.#??????????????????????
?????????????##.##??????#.#??????????????????????
????????????#...#???????#.#??????????????????????
????????????#.###########.#??????????????????????
????????????#............. ??????????????????????
?????????????#############???????????????????????