##?#############?#?###?###?#####?#######?????????
A.#.............#.#...#...#.....#.......#????????
#.#.#####.###.#.#.#.#.#.#.#.#.#.#.###.#.#????????
#.#.#...#.# #.#...#.#.#.#...#.#.#.. #.#.#????????
#.#.#.#.#.#.#.#####.#.#.#####.#.#####.#.#????????
#.# #.#.#...#.......#...#.....#...#...#R#????????
#.###.#.#################.####?##.#.##? ?????????
#.....#.........#.......#.....#?#...#????????????
?#####?########.#.#####.###.#.#??###?????????????
??????????????#...#???#...# #.#??????????????????
???????????????###?????##.###.#??????????????????
????????????????????????#.#...#??????????????????
????????????????????????#.#.##???????????????????
????????????????????????#...#????????????????????
?????????????????????????###?????????????????????
?????????????????????????????????????????????????
?????????????????????????????????????????????????
?????????????????????????????????????????????????
?????????????????????????????????????????????????
?????????????????????????????????????????????????
?????????????????????????????????????????????????
?????????????????????????????????????????????????
?????????????????????????????????????????????????
?????????????????????????????????????????????????
?????????????????????????????????????????????????
?????????????????????????????????????????????????
?????????????????????????????????????????????????
?????????????????????????????????????????????????
?????????????????????????????????????????????????
?????????????????????????????????????????????????
?????????????????????????????????????????????????
?????????????????????????????????????????????????
?????????????????????????????????????????????????