##?#############?#?###?###?#####?#######?????????
A.#.............#.#...#...#.....#.......#????????
#.#.#####.###.#.#.#.#.#.#.#.#.#.#.###.#.#????????
#.#.#...#.# #.#...#.#.#.#...#.#.#.. #.#.#????????
#.#.#.#.#.#.#.#####.#.#.#####.#.#####.#.#????###?
#.# #.#.#...#.......#...#.....#...#...#.#??? R..#
#.###.#.#################.####?##.#.###.#????##.#
#.....#.........#.......#.....#?#...#?#.#???#...#
?#####?########.#.#####.###.#.#??###??#.#####.# ?
??????????????#...#???#...# #.#???????#.......#??
???????????????###?????##.###.#????????#######???
????????????????????????#.#...#??????????????????
????????????????????????#.#.##???????????????????
????????????????????????#...#????????????????????
?????????????????????????###?????????????????????
?????????????????????????????????????????????????
?????????????????????????????????????????????????
?????????????????????????????????????????????????
?????????????????????????????????????????????????
?????????????????????????????????????????????????
?????????????????????????????????????????????????
?????????????????????????????????????????????????
?????????????????????????????????????????????????
?????????????????????????????????????????????????
?????????????????????????????????????????????????
?????????????????????????????????????????????????
?????????????????????????????????????????????????
?????????????????????????????????????????????????
?????????????????????????????????????????????????
?????????????????????????????????????????????????
?????????????????????????????????????????????????
?????????????????????????????????????????????????
?????????????????????????????????????????????????