##??????????????????????##?###???????????????????
A.#???????????????????? R.#... ??????????????????
#.#??###????????????????#.#.#.#??????????????????
#.#?#...#???????????????#...#.#??????????????????
#.#?#.#.#????????????????####.#??????????????????
#.#?#.#.#???????????????#.....#??????????????????
#.###.#.########?########.####???????????????????
#.....#.........#.......#.....#??????????????????
?#####?########.#.#####.###.#.#??????????????????
??????????????#...#???#...# #.#??????????????????
???????????????###?????##.###.#??????????????????
????????????????????????#.#...#??????????????????
????????????????????????#.#.##???????????????????
????????????????????????#...#????????????????????
?????????????????????????###?????????????????????
?????????????????????????????????????????????????
?????????????????????????????????????????????????
?????????????????????????????????????????????????
?????????????????????????????????????????????????
?????????????????????????????????????????????????
?????????????????????????????????????????????????
?????????????????????????????????????????????????
?????????????????????????????????????????????????
?????????????????????????????????????????????????
?????????????????????????????????????????????????
?????????????????????????????????????????????????
?????????????????????????????????????????????????
?????????????????????????????????????????????????
?????????????????????????????????????????????????
?????????????????????????????????????????????????
?????????????????????????????????????????????????
?????????????????????????????????????????????????
?????????????????????????????????????????????????