##?#############?#?###?###?#####?#######?#######?
A.#.............#.#...#...#.....#.......#.......#
#.#.#####.###.#.#.#.#.#.#.#.#.#.#.###.#.#.#####.#
#.#.#...#.# #.#...#.#.#.#...#.#.#.. #.#.#.#.....#
#.#.#.#.#.#.#.#####.#.#.#####.#.#####.#.#.#.####?
#.# #.#.#...#.......#...#.....#...#...#.#.#.....#
#.###.#.#################.####?##.#.###.#.#####.#
#.....#.........#.......#.....# #...# #.#.. #...#
?#####?########.#.#####.###.#.#.#####.#.#####.#.#
??????????????#...#???#...# #.#.. #...#.......#.#
???????????????###?????##.###.#.###.#.#########.#
????????????????????????#.#...#.#...#..... ???#.#
?????????????###????????#.#.###.#.#######.#???#.#
????????????#...#???????#...#...#.....#?#.#???#.#
????????????#.#.######???####.#.#####.#?#.##?##.#
????????????#.#....... ???#...#.. #...#?#...#...#
????????????#.#######.#####.#.#####.##???##.#.##?
????????????#.....#? R#.....#.....#.#?????#...#??
?????????????####.#####.####?####.#.#??????###???
????????????????#.....#...#?????#...#????????????
?????????????????####.###.##?????###?????????????
??????????????????#... ?#...#????????????????????
??????????????????#.####?##.#????????????????????
??????????????????#.....#...#????????????????????
?????????????????######.#.##?????????????????????
????????????????#.......#.#??????????????????????
???????????????##.##### #.#??????????????????????
??????????????#...#?????#.#??????????????????????
?????????????##.##??????#.#??????????????????????
????????????#...#???????#.#??????????????????????
????????????#.###########.#??????????????????????
????????????#............. ??????????????????????
?????????????#############???????????????????????