##?#############?#?###?###?#####?#######?#######?
A.#.............#.#...#...#.....#.......#.......#
#.#.#####.###.#.#.#.#.#.#.#.#.#.#.###.#.#.#####.#
#.#.#...#.# #.#...#.#.#.#...#.#.#.. #.#.#.#.....#
#.#.#.#.#.#.#.#####.#.#.#####.#.#####.#.#.#.####?
#.# #.#.#...#.......#...#.....#...#...#.#.#.....#
#.###.#.#################.####?##.#.###.#.#####.#
#.....#.........#.......#.....#?#...# #.#.. #...#
?#####?########.#.#####.###.#.#??####.#.#####.#.#
??????????????#...#???#...# #.#???#...#.......#.#
???????????????###?????##.###.#??##.#.#########.#
????????????????????????#.#...#?#...#..... ???#.#
????????????????????????#.#.##??#.##?####.#???#.#
????????????????????????#...#???#R ?????#.#???#.#
?????????????????????????###?????#??????#.##?##.#
????????????????????????????????????????#...#...#
?????????????????????????????????????????##.#.##?
??????????????????????????????????????????#...#??
???????????????????????????????????????????###???
?????????????????????????????????????????????????
?????????????????????????????????????????????????
?????????????????????????????????????????????????
?????????????????????????????????????????????????
?????????????????????????????????????????????????
?????????????????????????????????????????????????
?????????????????????????????????????????????????
?????????????????????????????????????????????????
?????????????????????????????????????????????????
?????????????????????????????????????????????????
?????????????????????????????????????????????????
?????????????????????????????????????????????????
?????????????????????????????????????????????????
?????????????????????????????????????????????????