##?#############?#?###?###?#####?#######?#######?
A.#.............#.#...#...#.....#.......#.......#
#.#.#####.###.#.#.#.#.#.#.#.#.#.#.###.#.#.#####.#
#.#.#...#.# #.#...#.#.#.#...#.#.#.. #.#.#.#.....#
#.#.#.#.#.#.#.#####.#.#.#####.#.#####.#.#.#.####?
#.# #.#.#...#.......#...#.....#...#...#.#.#.....#
#.###.#.#################.####?##.#.###.#.#####.#
#.....#.........#.......#.....# #...# #.#.. #...#
?#####?########.#.#####.###.#.#.#####.#.#####.#.#
??????????????#...#???#...# #.#.. #...#.......#.#
???????????????###?????##.###.#.###.#.#########.#
????????????????????????#.#...#.#...#..... ???#.#
????????????????????????#.#.###.#.#######.#???#.#
????????????????????????#...#...#.....#?#.#???#.#
?????????????????????????####.#.#####.#?#.##?##.#
???????????????????????????? .#R ?#...#?#...#...#
????????????????????????????#.#####.##???##.#.##?
????????????????????????????#.....#.#?????#...#??
?????????????????????????????####.#.#??????###???
????????????????????????????????#...#????????????
?????????????????????????????????###?????????????
?????????????????????????????????????????????????
?????????????????????????????????????????????????
?????????????????????????????????????????????????
?????????????????????????????????????????????????
?????????????????????????????????????????????????
?????????????????????????????????????????????????
?????????????????????????????????????????????????
?????????????????????????????????????????????????
?????????????????????????????????????????????????
?????????????????????????????????????????????????
?????????????????????????????????????????????????
?????????????????????????????????????????????????