##?#############?#?###?###?#####?#######?#######?
A.#.............#.#...#...#.....#.......#.......#
#.#.#####.###.#.#.#.#.#.#.#.#.#.#.###.#.#.#####.#
#.#.#...#.# #.#...#.#.#.#...#.#.#.. #.#.#.#.....#
#.#.#.#.#.#.#.#####.#.#.#####.#.#####.#.#.#.####?
#.# #.#.#...#.......#...#.....#...#...#.#.#.....#
#.###.#.#################.####?##.#.###.#.#####.#
#.....#.........#.......#.....# #...# #.#.. #...#
?##############.#.#####.###.#.#.#####.#.#####.#.#
#...#........ #...#.. #...# #.#.. #...#.......#.#
#.#.#.###.#########.#####.###.#.###.#.#########.#
#.#.#.# #...............#.#...#.#...#..... ???#.#
#.#.#.#.#########.#####.#.#.###.#.#######.#???#.#
#.#.#.#...# #...#.... #.#...#...#.....# #.#???#.#
#.#.#.#.#.#.#.#.#######.#####.#.#####.#.#.##?##.#
#.# #.#.#...#.#.......... #...#.. #...#.#...#...#
#.###.#.###.#.#######.#####.#.#####.###.###.#.##?
#...#.#...#.#.....# ..#.....#.....#.#.....#...#.#
#.#.#.#.#.#.#####.#####.#########.#.#.#.#.#####.#
#.#...#.#.#.# ..#.....#...# ... #...# #.#.......#
#.#####.#.#.###.#####.###.###.#########.#######.#
#.# ....#.#.......#.... #...#.... #.....#.......#
#.#######.#######.#.####?##.###.###.#.###.######?
#.#.....#.......# #.....#...#...#...#.# #.....#??
#.#.###.#.#####.#######.#.###.###.###.#.#####.#??
#.#...#.# #.....#.......#.# #...#...#.#.....#.#??
#.###.#.###.#.###.#####.#.#.#.#.###.#.###.#.#.#??
#.....#...#.# #...#.....#.#...#.....#.#...# #.#??
?########.#.###.###.#####.####?######.#.#####.#??
#...#...#.#.#...# ..... #.#...#.......#.#...#.#??
#.#.#.#.#.#.#.###########.#.#.#.#######.#.#.#.#??
#.#...#.....#...............#...#.........#R.. ??
?#?###?#####?###############?###?#########?###???