##?#############?#?###?###?#####?#######?#######?
A.#.............#.#...#...#.....#.......#.......#
#.#.#####.###.#.#.#.#.#.#.#.#.#.#.###.#.#.#####.#
#.#.#...#.# #.#...#.#.#.#...#.#.#.. #.#.#.#.....#
#.#.#.#.#.#.#.#####.#.#.#####.#.#####.#.#.#.####?
#.# #.#.#...#.......#...#.....#...#...#.#.#.....#
#.###.#.#################.####?##.#.###.#.#####.#
#.....#.........#.......#.....#?#...# #.#.. #...#
?#####?########.#.#####.###.#.#??####.#.#####.#.#
??????????????#...#???#...# #.#???#...#.......#.#
???????????????###?????##.###.#??##.#.#########.#
????????????????????????#.#...# #...#..... ???#.#
????????????????????????#.#.###R#.#######.#???#.#
????????????????????????#...#...#.....#?#.#???#.#
?????????????????????????####.# ?####.#?#.##?##.#
???????????????????????????? .#???#...#?#...#...#
????????????????????????????#.#####.##???##.#.##?
????????????????????????????#.....#.#?????#...#??
?????????????????????????????####.#.#??????###???
????????????????????????????????#...#????????????
?????????????????????????????????###?????????????
?????????????????????????????????????????????????
?????????????????????????????????????????????????
?????????????????????????????????????????????????
?????????????????????????????????????????????????
?????????????????????????????????????????????????
?????????????????????????????????????????????????
?????????????????????????????????????????????????
?????????????????????????????????????????????????
?????????????????????????????????????????????????
?????????????????????????????????????????????????
?????????????????????????????????????????????????
?????????????????????????????????????????????????