##?#############?#?###?###?#####???###???????????
A.#.............#.#...#...#.....#? R.. ??????????
#.#.#####.###.#.#.#.#.#.#.#.#.#.#??##.#??????????
#.#.#...#.# #.#...#.#.#.#...#.#.#???#.#??????????
#.#.#.#.#.#.#.#####.#.#.#####.#.##?##.#??????????
#.# #.#.#...#.......#...#.....#...#...#??????????
#.###.#.#################.####?##.#.##???????????
#.....#.........#.......#.....#?#...#????????????
?#####?########.#.#####.###.#.#??###?????????????
??????????????#...#???#...# #.#??????????????????
???????????????###?????##.###.#??????????????????
????????????????????????#.#...#??????????????????
????????????????????????#.#.##???????????????????
????????????????????????#...#????????????????????
?????????????????????????###?????????????????????
?????????????????????????????????????????????????
?????????????????????????????????????????????????
?????????????????????????????????????????????????
?????????????????????????????????????????????????
?????????????????????????????????????????????????
?????????????????????????????????????????????????
?????????????????????????????????????????????????
?????????????????????????????????????????????????
?????????????????????????????????????????????????
?????????????????????????????????????????????????
?????????????????????????????????????????????????
?????????????????????????????????????????????????
?????????????????????????????????????????????????
?????????????????????????????????????????????????
?????????????????????????????????????????????????
?????????????????????????????????????????????????
?????????????????????????????????????????????????
?????????????????????????????????????????????????