##?#############?#?###?###?#####?#######?????????
A.#.............#.#...#...#.....#.......#????????
#.#.#####.###.#.#.#.#.#.#.#.#.#.#.###.#.#????????
#.#.#...#.# #.#...#.#.#.#...#.#.#.. #.#.#????????
#.#.#.#.#.#.#.#####.#.#.#####.#.#####.#.#????????
#.# #.#.#...#.......#...#.....#...#...#.#????????
#.###.#.#################.####?##.#.###.#????## ?
#.....#.........#.......#.....#?#...#?#.#???#..R#
?#####?########.#.#####.###.#.#??###??#.#####.# ?
??????????????#...#???#...# #.#???????#.......#??
???????????????###?????##.###.#????????#######???
????????????????????????#.#...#??????????????????
????????????????????????#.#.##???????????????????
????????????????????????#...#????????????????????
?????????????????????????###?????????????????????
?????????????????????????????????????????????????
?????????????????????????????????????????????????
?????????????????????????????????????????????????
?????????????????????????????????????????????????
?????????????????????????????????????????????????
?????????????????????????????????????????????????
?????????????????????????????????????????????????
?????????????????????????????????????????????????
?????????????????????????????????????????????????
?????????????????????????????????????????????????
?????????????????????????????????????????????????
?????????????????????????????????????????????????
?????????????????????????????????????????????????
?????????????????????????????????????????????????
?????????????????????????????????????????????????
?????????????????????????????????????????????????
?????????????????????????????????????????????????
?????????????????????????????????????????????????