##?#############?#?###?###?#####?#######?#######?
A.#.............#.#...#...#.....#.......#.......#
#.#.#####.###.#.#.#.#.#.#.#.#.#.#.###.#.#.#####.#
#.#.#...#.# #.#...#.#.#.#...#.#.#.. #.#.#.#.....#
#.#.#.#.#.#.#.#####.#.#.#####.#.#####.#.#.#.####?
#.# #.#.#...#.......#...#.....#...#...#.#.#.....#
#.###.#.#################.####?##.#.###.#.#####.#
#.....#.........#.......#.....# #...# #.#.. #...#
?##############.#.#####.###.#.#.#####.#.#####.#.#
#...#........ #...#.. #...# #.#.. #...#.......#.#
#.#.#.###.#########.#####.###.#.###.#.#########.#
#.#.#.# #...............#.#...#.#...#..... ???#.#
#.#.#.#.#########.#####.#.#.###.#.#######.#???#.#
#.#.#.#...# #...#.... #.#...#...#.....# #.#???#.#
#.#.#.#.#.#.#.#.#######.#####.#.#####.#.#.##?##.#
#.# #.#.#...#.#.......... #...#.. #...#.#...#...#
#.###.#.###.#.#######.#####.#.#####.###.###.#.##?
#...#.#...#.#.....# ..#.....#.....#.#.....#...#.#
#.#.#.#.#.#.#####.#####.#########.#.#.#.#.#####.#
#.#...#.#.#.# ..#.....#...# ... #...# #.#.......#
#.#####.#.#.###.#####.###.###.#########.#######.#
#.# ....#.#.......#.... #...#.... #.....#.......#
#.#######.#######.#.####?##.###.###.#.###.######?
#.#.....#.......# #.....#...#...#...#.#?#.....#??
#.#.###.#.#####.#######.#.###.###.###.#??####.#??
#.#...#.# #.....#.......#.# #...#...#.#?????#.#??
#.###.#.###.#.###.#####.#.#.#.#.###.#.### ??#.#??
#.....#...#.# #...#.....#.#...#.....#.#..R#?#.#??
?########.#.###.###.#####.####?######.#.#####.#??
#...#...#.#.#...# ..... #.#...#.......#.#...#.#??
#.#.#.#.#.#.#.###########.#.#.#.#######.#.#.#.#??
#.#...#.....#...............#...#????? ...#... ??
?#?###?#####?###############?###???????###?###???