##?#############?#?###?###?#####?#######?#######?
A.#.............#.#...#...#.....#.......#.......#
#.#.#####.###.#.#.#.#.#.#.#.#.#.#.###.#.#.#####.#
#.#.#...#.# #.#...#.#.#.#...#.#.#.. #.#.#.#.....#
#.#.#.#.#.#.#.#####.#.#.#####.#.#####.#.#.#.####?
#.# #.#.#...#.......#...#.....#...#...#.#.#.....#
#.###.#.#################.####?##.#.###.#.#####.#
#.....#.........#.......#.....#?#...# #.#.. #...#
?#####?########.#.#####.###.#.#??####.#.#####.#.#
??????????????#...#???#...# #.#???? R.#.......#.#
???????????????###?????##.###.#?????#.#########.#
????????????????????????#.#...#?????#..... ???#.#
????????????????????????#.#.##???????####.#???#.#
????????????????????????#...#???????????#.#???#.#
?????????????????????????###????????????#.##?##.#
????????????????????????????????????????#...#...#
?????????????????????????????????????????##.#.##?
??????????????????????????????????????????#...#??
???????????????????????????????????????????###???
?????????????????????????????????????????????????
?????????????????????????????????????????????????
?????????????????????????????????????????????????
?????????????????????????????????????????????????
?????????????????????????????????????????????????
?????????????????????????????????????????????????
?????????????????????????????????????????????????
?????????????????????????????????????????????????
?????????????????????????????????????????????????
?????????????????????????????????????????????????
?????????????????????????????????????????????????
?????????????????????????????????????????????????
?????????????????????????????????????????????????
?????????????????????????????????????????????????