#######################################
A.#       #              .....#.......#
#.##### # # #############.###.#.#####.#
#.#...# #     #...........# #...#...#.#
#.#.#.####### #.# ######### #####.#.#.#
#.#.#.....#   #.# #.......# #   #.#.#.#
#.#.#####.#####.###.#####.# # # #.#.#.#
#.#.#   #...#...#...#   #.#   # #.#...#
#.#.# # ###.#.###.### # #.##### #.#####
#...# #   #.#.....    # #.#     #.....#
######### #.### #########.# #########.#
#       # #...#   #.......#.......#...#
##### # # ###.### #.#######.#####.#.###
#     #     #.# # #...# #...# #...#...#
# ###########.# # ###.# #.### #.#####.#
# #...#...#...# # #...# #...# #.......#
# #.#.#.#.#.### # #.### ###.# #########
#...#...#.#...#   #...#   #.#    ...# #
#.#######.###.# #####.### #.# ###.#.# #
#.....#...  #.# #.....#   #.# #...#...#
#####.#.### #.# #.##### ###.###.#####.#
#...#.#.#   #.# #...#     #...#.#  ...#
#.#.#.#.#####.#####.##### ###.#.###.###
#.#...#.......#.....#       #.#...#.# #
#.#############.##### #######.###.#.# #
#...............#            .....#...B
#######################################