##?#######?###################?#######?
A #       #                   #       #
# ##### # # ############# ### # ##### #
# #   # #     #           # #   #   # #
# # # ####### # # ######### ##### # # #
# # #     #   # # #       # #   # # # #
# # ##### ##### ### ##### # # # # # # #
# # #   #   #   #   #???# #   # # #   #
# # # # ### # ### ##????# ##### # ####?
#   # #   # #      ?????# #     #     #
?######## # ### ##?###### # ######### #
#       # #   #   #       #       #   #
?#### # # ### ### # ####### ##### # ##?
#     #     # # # #   # #   # #   #   #
# ####?###### # # ### # # ### # ##### #
# #   #   #   # # #   # #   # #       #
# # # # # # ### # # ### ### # ########?
#   #   # #   #   #   #   # #       # #
# ####### ### # ##### ### # # ### # # #
#     #    ?# # #     #   # # #   #   #
?#### # ##??# # # ##### ### ### ##?## #
#   # # #???# # #   #     #   # #?    #
# # # # ##### ##### ##### ### # ### ##?
# #   #       #     #       # #   # #??
# ############# ##### ####### ### # # #
#               #                 #   B
?###############?#################?####