#######################################
A.#.......#...................#.......#
#.#####.#.#.#############.###.#.#####.#
#.#...# #.....#...........# #...#...#.#
#.#.#.#######.#.#.#########.#####.#.#.#
#.#.#.....# ..#.# #.......#.#...#.#.#.#
#.#.#####.#####.###.#####.#.#.#.#.#.#.#
#.#.#...#...#...#...#   #.#...#.#.#...#
#.#.#.#.###.#.###.### # #.#####.#.#####
#...# #...#.#.....    # #.#.....#.....#
#########.#.###.#########.#.#########.#
#.......#.#...#...#.......#.......#...#
#####.#.#.###.###.#.#######.#####.#.###
#.....#.... #.# #.#...# #...# #...#...#
#.###########.#.#.###.#.#.###.#.#####.#
#.#...#...#...#.#.#...#.#...#.#.......#
#.#.#.#.#.#.###.#.#.###.###.#.#########
#...#...#.#...#...#...#...#.#.......#.#
#.#######.###.#.#####.###.#.#.###.#.#.#
#.....#...  #.#.#.....#...#.# #...#...#
#####.#.### #.#.#.#####.###.###.#####.#
#...#.#.#   #.# #...# ....#...#.#  ...#
#.#.#.#.#####.#####.#####.###.#.###.###
#.#...#.......#.....#...... #.#...#.# #
#.#############.#####.#######.###.#.# #
#...............#.................#...B
#######################################