#################################################
A.#.............#.#...#...#.....#.......#.......#
#.#.#####.###.#.#.#.#.#.#.#.#.#.#.###.#.#.#####.#
#.#.#...#.# #.#...#.#.#.#...#.#.#.. #.#.#.#.....#
#.#.#.#.#.#.#.#####.#.#.#####.#.#####.#.#.#.#####
#.# #.#.#...#.......#...#.....#...#...#.#.#.....#
#.###.#.#################.#######.#.###.#.#####.#
#.....#.........#.......#.....# #...# #.#.. #...#
###############.#.#####.###.#.#.#####.#.#####.#.#
#...#........ #...#.. #...# #.#.. #...#.......#.#
#.#.#.###.#########.#####.###.#.###.#.#########.#
#.#.#.# #...............#.#...#.#...#.....    #.#
#.#.#.#.#########.#####.#.#.###.#.#######.### #.#
#.#.#.#...# #...#.... #.#...#...#.....# #.#   #.#
#.#.#.#.#.#.#.#.#######.#####.#.#####.#.#.#####.#
#.# #.#.#...#.#.......... #...#.. #...#.#...#...#
#.###.#.###.#.#######.#####.#.#####.###.###.#.###
#...#.#...#.#.....# ..#.....#.....#.#.....#...#.#
#.#.#.#.#.#.#####.#####.#########.#.#.#.#.#####.#
#.#...#.#.#.# ..#.....#...# ... #...# #.#.......#
#.#####.#.#.###.#####.###.###.#########.#######.#
#.# ....#.#.......#.... #...#.... #.....#.......#
#.#######.#######.#.#######.###.###.#.###.#######
#.#.....#.......# #.....#...#...#...#.# #.....# #
#.#.###.#.#####.#######.#.###.###.###.#.#####.# #
#.#...#.# #.....#.......#.# #...#...#.#.....#.# #
#.###.#.###.#.###.#####.#.#.#.#.###.#.###.#.#.# #
#.....#...#.# #...#.....#.#...#.....#.#...# #.# #
#########.#.###.###.#####.###########.#.#####.# #
#...#...#.#.#...# ..... #.#...#.......#.#...#.# #
#.#.#.#.#.#.#.###########.#.#.#.#######.#.#.#.# #
#.#...#.....#...............#...#.........#.....B
#################################################