##?#######?###################?#######?
A.#.......#...................#.......#
#.#####.#.#.#############.###.#.#####.#
#.#...# #.....#...........# #...#...#.#
#.#.#.#######.#.#.#########.#####.#.#.#
#.#.#.....# ..#.# #.......#.#...#.#.#.#
#.#.#####.#####.###.#####.#.#.#.#.#.#.#
#.#.#...#...#...#...#???#.#...#.#.#...#
#.#.#.#.###.#.###.##????#.#####.#.####?
#...# #...#.#..... ?????#.#.....#.....#
?########.#.###.##?######.#.#########.#
#.......#.#...#...#.......#.......#...#
?####.#.#.###.###.#.#######.#####.#.##?
#.....#.... #.# #.#...#?#...#?#...#...#
#.####?######.#.#.###.#?#.##??#.#####.#
#.#...#...#...#.#.#...#?#...#?#.......#
#.#.#.#.#.#.###.#.#.##???##.#??#######?
#...#...#.#...#...#...#???#.#??????????
#.#######.###.#.#####.#???#.#??????????
#.....#... ?#.#.#.....#???#.#??????????
?####.#.##??#.#.#.####????#.##?????????
#...#.#.#???#.# #...#?????#...#????????
#.#.#.#.#####.#####.#??????##.#????????
#.#...#.......#.....#???????#.#????????
#.#############.####????????#R#????????
#...............#???????????? ?????????
?###############???????????????????????