##?#######?###################?#######?
A.#.......#...................#.......#
#.#####.#.#.#############.###.#.#####.#
#.#...# #.....#...........# #...#...#.#
#.#.#.#######.#.#.#########.#####.#.#.#
#.#.#.....# ..#.# #.......#.#...#.#.#.#
#.#.#####.#####.###.#####.#.#.#.#.#.#.#
#.#.#...#...#...#...#???#.#...#.#.#...#
#.#.#.#.###.#.###.##????#.#####.#.####?
#...# #...#.#..... ?????#.#.....#.....#
?########.#.###.##?######.#.#########.#
#.......#.#...#...#.......#.......#...#
?####.#.#.###.###.#.#######.#####.#.##?
#.....#.... #.# #.#...# #...#?#...#...#
#.####?######.#.#.###.#R#.##??#.#####.#
#.#...#...#...#.#.#...#.#...#?#.......#
#.#.#.#.#.#.###.#.#.###.###.#??#######?
#...#...#.#...#...#...#...#.#??????????
#.#######.###.#.#####.###.#.#??????????
#.....#... ?#.#.#.....#...#.#??????????
?####.#.##??#.#.#.#####.###.##?????????
#...#.#.#???#.# #...#? ...#...#????????
#.#.#.#.#####.#####.#####.###.#????????
#.#...#.......#.....#..... ?#.#????????
#.#############.#####.#######.#????????
#...............#??? ......... ????????
?###############?????#########?????????