##?????????????????????????????????????
A.#????????????????????????????????????
#.####?????????????????????????????????
#.#...#????????????????????????????????
#.#.#.####?????????????????????????????
#.#.#.....#????????????????????????????
#.#.#####.##???????????????????????????
#.#.#???#...#??????????????????????????
#.#.#????##.#??????????????????????????
#...#?????#R#??????????????????????????
?###??????? ???????????????????????????
???????????????????????????????????????
???????????????????????????????????????
???????????????????????????????????????
???????????????????????????????????????
???????????????????????????????????????
???????????????????????????????????????
???????????????????????????????????????
???????????????????????????????????????
???????????????????????????????????????
???????????????????????????????????????
???????????????????????????????????????
???????????????????????????????????????
???????????????????????????????????????
???????????????????????????????????????
???????????????????????????????????????
???????????????????????????????????????