##?????????????????????????????????????
A.#????????????????????????????????????
#.####?????????????????????????????????
#.#...#????????????????????????????????
#.#.#.####?????????????????????????????
#.#.#.....#????????????????????????????
#.#.#####.##???????????????????????????
#.#.#...#...#??????????????????????????
#.#.#.#.###.#??????????????????????????
#...# #...#.#??????????????????????????
?########.#.##?????????????????????????
#.......#.#...#????????????????????????
?####.#.#.###.#??????#?????????????????
#.....#.... #.#????? R#????????????????
#.####?######.#????##.#????????????????
#.#...#...#...#???#...#????????????????
#.#.#.#.#.#.##????#.##?????????????????
#...#...#.#...#???#...#????????????????
#.#######.###.#??####.#????????????????
#.....#... ?#.#?#.....#????????????????
?####.#.##??#.#?#.####?????????????????
#...#.#.#???#.#?#...#??????????????????
#.#.#.#.#####.#####.#??????????????????
#.#...#.......#.....#??????????????????
#.#############.####???????????????????
#...............#??????????????????????
?###############???????????????????????