##?#######?###################?#######?
A.#.......#...................#.......#
#.#####.#.#.#############.###.#.#####.#
#.#...# #.....#...........# #...#...#.#
#.#.#.#######.#.#.#########.#####.#.#.#
#.#.#.....# ..#.# #.......#.#...#.#.#.#
#.#.#####.#####.###.#####.#.#.#.#.#.#.#
#.#.#...#...#...#...#???#.#...#.#.#...#
#.#.#.#.###.#.###.##????#.#####.#.####?
#...# #...#.#..... ?????#.#.....#.....#
?########.#.###.##?######.#.#########.#
#.......#.#...#...#.......#.......#...#
?####.#.#.###.###.#.#######.#####.#.##?
#.....#.... #.# #.#...# #...#?#...#...#
#.####?######.#.#.###.#.#.##??#.#####.#
#.#...#...#...#.#.#...#.#...#?#.......#
#.#.#.#.#.#.###.#.#.###.###.#??#######?
#...#...#.#...#...#...#...#.#??????????
#.#######.###.#.#####.###.#.#??????????
#.....#... ?#.#.#.....#...#.#??????????
?####.#.##??#.#.#.#####.###.##?????????
#...#.#.#???#.# #...# ....#...#????????
#.#.#.#.#####.#####.#####.###.#????????
#.#...#.......#.....#...... #.#????????
#.#############.#####.#######.#????????
#...............#.......R..... ????????
?###############?#############?????????