##?????????????????????????????????????
A.#????????????????????????????????????
#.####?????????????????????????????????
#.#...#????????????????????????????????
#.#.#.####?????????????????????????????
#.#.#.....#????????????????????????????
#.#.#####.##???????????????????????????
#.#.#...#...#??????????????????????????
#.#.#.#.###.#??????????????????????????
#...# #...#.#??????????????????????????
?########.#.##?????????????????????????
#.......#.#...#????????????????????????
?####.#.#.###.#????????????????????????
#.....#.... #.#????????????????????????
#.####?######.#????????????????????????
#.#...#...#...#????????????????????????
#.#.#.#.#.#.##?????????????????????????
#...#...#.#...#????????????????????????
#.#######.###.#????????????????????????
#.....#... ?#.#????????????????????????
?####.#.##??#.#????????????????????????
#...#.#.#???#.#????????????????????????
#.#.#.#.#####.#????????????????????????
#.#...#.......#????????????????????????
#.############?????????????????????????
#............R ????????????????????????
?#############?????????????????????????