##?#######?###################?#######?
A.#.......#...................#.......#
#.#####.#.#.#############.###.#.#####.#
#.#...# #.....#...........# #...#...#.#
#.#.#.#######.#.#.#########.#####.#.#.#
#.#.#.....# ..#.# #.......#.#...#.#.#.#
#.#.#####.#####.###.#####.#.#.#.#.#.#.#
#.#.#...#...#...#...#???#.#...#.#.#...#
#.#.#.#.###.#.###.##????#.#####.#.####?
#...# #...#.#..... ?????#.#.....#.....#
?########.#.###.##?######.#.#########.#
#.......#.#...#...#.......#.......#...#
?####.#.#.###.###.#.#######.#####.#.##?
#.....#.... #.# #.#...# #...# #...#...#
#.####?######.#.#.###.#.#.###.#.#####.#
#.#...#...#...#.#.#...#.#...#.#.......#
#.#.#.#.#.#.###.#.#.###.###.#.########?
#...#...#.#...#...#...#...#.#R.... ????
#.#######.###.#.#####.###.#.#.###.#????
#.....#... ?#.#.#.....#...#.# #...#????
?####.#.##??#.#.#.#####.###.###.##?????
#...#.#.#???#.# #...# ....#...#.#??????
#.#.#.#.#####.#####.#####.###.#.##?????
#.#...#.......#.....#...... #.#...#????
#.#############.#####.#######.###.#????
#...............#.................#????
?###############?#################?????