##?????????????????????????????????????
A.#????????????????????????????????????
#.####?????????????????????????????????
#.#...#????????????????????????????????
#.#.#.####?????????????????????????????
#.#.#.....#????????????????????????????
#.#.#####.#????????????????????????????
#.#.#???#.R ???????????????????????????
#.#.#????##????????????????????????????
#...#??????????????????????????????????
?###???????????????????????????????????
???????????????????????????????????????
???????????????????????????????????????
???????????????????????????????????????
???????????????????????????????????????
???????????????????????????????????????
???????????????????????????????????????
???????????????????????????????????????
???????????????????????????????????????
???????????????????????????????????????
???????????????????????????????????????
???????????????????????????????????????
???????????????????????????????????????
???????????????????????????????????????
???????????????????????????????????????
???????????????????????????????????????
???????????????????????????????????????