##?????????????????????????????????????
A.#????????????????????????????????????
#.####?????????????????????????????????
#.#...#????????????????????????????????
#.#.#.####?????????????????????????????
#.#.#.....#????????????????????????????
#.#.#####.##???????????????????????????
#.#.#???#...#??????????????????????????
#.#.#????##.#??????????????????????????
#...#?????#.#??????????????????????????
?###??????#.##?????????????????????????
??????????#...#????????????????????????
???????????##.#????????????????????????
????????????#.#????????????????????????
???????????##.#????????????????????????
??????????#...#????????????????????????
??????????#.##?????????????????????????
??????????#..R#????????????????????????
???????????## ?????????????????????????
???????????????????????????????????????
???????????????????????????????????????
???????????????????????????????????????
???????????????????????????????????????
???????????????????????????????????????
???????????????????????????????????????
???????????????????????????????????????
???????????????????????????????????????