##?????????????????????????????????????
A.#????????????????????????????????????
#.####?????????????????????????????????
#.#...#????????????????????????????????
#.#.#.####?????????#######?????????????
#.#.#.....#???????#.......#????????????
#.#.#####.##?????##.#####.#????????????
#.#.#...#...#???#...#???#.#????????????
#.#.#.#.###.#??##.##????#.#????????????
#...# #...#.#? ... ?????#.#????????????
?########.#.###.##?######.#????????????
#.......#.#...#...#.......#????????????
?####.#.#.###.###.#.######?????????????
#.....#.... #.#?#.#...#????????????????
#.####?######.#?#.###.#????????????????
#.#...#...#...#?#R#...#????????????????
#.#.#.#.#.#.##??? #.##?????????????????
#...#...#.#...#???#...#????????????????
#.#######.###.#??####.#????????????????
#.....#... ?#.#?#.....#????????????????
?####.#.##??#.#?#.####?????????????????
#...#.#.#???#.#?#...#??????????????????
#.#.#.#.#####.#####.#??????????????????
#.#...#.......#.....#??????????????????
#.#############.####???????????????????
#...............#??????????????????????
?###############???????????????????????