##?????????????????????????????????????
A.#????????????????????????????????????
#.####?????????????????????????????????
#.#...#????????????????????????????????
#.#.#.####?????????????????????????????
#.#.#.....#????????????????????????????
#.#.#####.##???????????????????????????
#.#.#???#...#??????????????????????????
#.#.#????##.#??????????????????????????
#...#?????#.#??????????????????????????
?#######? #.##?????????????????????????
#.......#R#...#????????????????????????
?####.#.#.###.#????????????????????????
#.....#... ?#.#????????????????????????
#.####?###?##.#????????????????????????
#.#...#...#...#????????????????????????
#.#.#.#.#.#.##?????????????????????????
#...#...#.#...#????????????????????????
? ##?####.###.#????????????????????????
??????#... ?#.#????????????????????????
??????#.##??#.#????????????????????????
??????#.#???#.#????????????????????????
??????#.#####.#????????????????????????
??????#.......#????????????????????????
???????#######?????????????????????????
???????????????????????????????????????
???????????????????????????????????????