##?#######?###################?#######?
A.#.......#...................#.......#
#.#####.#.#.#############.###.#.#####.#
#.#...# #.....#...........# #...#...#.#
#.#.#.#######.#.#.#########.#####.#.#.#
#.#.#.....# ..#.# #.......#.#...#.#.#.#
#.#.#####.#####.###.#####.#.#.#.#.#.#.#
#.#.#...#...#...#...#???#.#...#.#.#...#
#.#.#.#.###.#.###.##????#.#####.#.####?
#...# #...#.#..... ?????#.#.....#.....#
?########.#.###.##?######.#.#########.#
#.......#.#...#...#.......#.......#...#
?####.#.#.###.###.#.#######.#####.#.##?
#.....#.... #.# #.#...#?#...#?#...#...#
#.####?######.#.#.###.#?#.##??#.#####.#
#.#...#...#...#.#.#...#?#...#?#.......#
#.#.#.#.#.#.###.#.#.##???##.#??#######?
#...#...#.#...#...#...#???#R#??????????
#.#######.###.#.#####.#???? ???????????
#.....#... ?#.#.#.....#????????????????
?####.#.##??#.#.#.####?????????????????
#...#.#.#???#.# #...#??????????????????
#.#.#.#.#####.#####.#??????????????????
#.#...#.......#.....#??????????????????
#.#############.####???????????????????
#...............#??????????????????????
?###############???????????????????????