##?????????????????????????????????????
A.#????????????????????????????????????
#.####?????????????????????????????????
#.#...#????????????????????????????????
#.#.#.####?????????#######?????????????
#.#.#.....#???????#.......#????????????
#.#.#####.##?????##.#####.#????????????
#.#.#...#...#???#...#???#.#????????????
#.#.#.#.###.#??##.##????#.#????????????
#...# #...#.#? ... ?????#.#????????????
?########.#.###.##?######.#????????????
#.......#.#...#..R#.......#????????????
?####.#.#.###.### #.######?????????????
#.....#.... #.#???#...#????????????????
#.####?######.#????##.#????????????????
#.#...#...#...#???#...#????????????????
#.#.#.#.#.#.##????#.##?????????????????
#...#...#.#...#???#...#????????????????
#.#######.###.#??####.#????????????????
#.....#... ?#.#?#.....#????????????????
?####.#.##??#.#?#.####?????????????????
#...#.#.#???#.#?#...#??????????????????
#.#.#.#.#####.#####.#??????????????????
#.#...#.......#.....#??????????????????
#.#############.####???????????????????
#...............#??????????????????????
?###############???????????????????????