##?????????????????????????????????????
A.#????????????????????????????????????
#.####?????????????????????????????????
#.#...#????????????????????????????????
#.#.#.####?????????????????????????????
#.#.#.....#????????????????????????????
#.#.#####.##???????????????????????????
#.#.#???#...#??????????????????????????
#.#.#????##.#??????????????????????????
#...#?????#.#??????????????????????????
?###??????#.##?????????????????????????
??????????#...#????????????????????????
???????????##.#????????????????????????
????????????#.#????????????????????????
???????????##.#????????????????????????
??????????#...#????????????????????????
??????????#.##?????????????????????????
??????????#...#????????????????????????
???????????##.#????????????????????????
????????????#.#????????????????????????
????????????#.#????????????????????????
????????????#.#????????????????????????
???????????##.#????????????????????????
?????????? R..#????????????????????????
???????????###?????????????????????????
???????????????????????????????????????
???????????????????????????????????????