##?#######?###################?#######?
A.#.......#...................#.......#
#.#####.#.#.#############.###.#.#####.#
#.#...# #.....#...........# #...#...#.#
#.#.#.#######.#.#.#########.#####.#.#.#
#.#.#.....# ..#.# #.......#.#...#.#.#.#
#.#.#####.#####.###.#####.#.#.#.#.#.#.#
#.#.#...#...#...#...#???#.#...#.#.#...#
#.#.#.#.###.#.###.##????#.#####.#.####?
#...# #...#.#..... ?????#.#.....#.....#
?########.#.###.##?######.#.#########.#
#.......#.#...#...#.......#.......#...#
?####.#.#.###.###.#.#######.#####.#.##?
#.....#.... #.# #.#...#?#...#?#...#...#
#.####?######.#.#.###.#?#.##??#.#####.#
#.#...#...#...#.#.#...#?#...#?#.......#
#.#.#.#.#.#.###.#.#.##???##.#??#######?
#...#...#.#...#...#...#???#.#??????????
#.#######.###.#.#####.#???#.#??????????
#.....#... ?#.#.#.....#???#.#??????????
?####.#.##??#.#.#.####? ###.##?????????
#...#.#.#???#.# #...#? R..#...#????????
#.#.#.#.#####.#####.#####.###.#????????
#.#...#.......#.....#..... ?#.#????????
#.#############.#####.#######.#????????
#...............#??? ......... ????????
?###############?????#########?????????