##????????????????########?????????????
A.#?????????????? R....... ????????????
#.####?????????##########.#????????????
#.#...#???????#...........#????????????
#.#.#.####????#.#.########?????????????
#.#.#.....#???#.# #.......#????????????
#.#.#####.##?##.###.#####.#????????????
#.#.#...#...#...#...#???#.#????????????
#.#.#.#.###.#.###.##????#.#????????????
#...# #...#.#..... ?????#.#????????????
?########.#.###.##?######.#????????????
#.......#.#...#...#.......#????????????
?####.#.#.###.###.#.######?????????????
#.....#.... #.# #.#...#????????????????
#.####?######.#.#.###.#????????????????
#.#...#...#...#.#.#...#????????????????
#.#.#.#.#.#.###.#.#.##?????????????????
#...#...#.#...#...#...#????????????????
#.#######.###.#.#####.#????????????????
#.....#... ?#.#.#.....#????????????????
?####.#.##??#.#.#.####?????????????????
#...#.#.#???#.# #...#??????????????????
#.#.#.#.#####.#####.#??????????????????
#.#...#.......#.....#??????????????????
#.#############.####???????????????????
#...............#??????????????????????
?###############???????????????????????