##?#######?###################?#######?
A.#.......#...................#.......#
#.#####.#.#.#############.###.#.#####.#
#.#...# #.....#...........#?#...#...#.#
#.#.#.#######.#.#.########???####.#.#.#
#.#.#.....# ..#.# #.......#?????#.#.#.#
#.#.#####.#####.###.#####.#?????#.#.#.#
#.#.#...#...#...#...#???#.#?????#.#...#
#.#.#.#.###.#.###.##????#.#?????#.####?
#...# #...#.#..... ?????#.#?????#.....#
?########.#.###.##?######.#??????####.#
#.......#.#...#...#.......#????????? R#
?####.#.#.###.###.#.######???????????#?
#.....#.... #.# #.#...#????????????????
#.####?######.#.#.###.#????????????????
#.#...#...#...#.#.#...#????????????????
#.#.#.#.#.#.###.#.#.##?????????????????
#...#...#.#...#...#...#????????????????
#.#######.###.#.#####.#????????????????
#.....#... ?#.#.#.....#????????????????
?####.#.##??#.#.#.####?????????????????
#...#.#.#???#.# #...#??????????????????
#.#.#.#.#####.#####.#??????????????????
#.#...#.......#.....#??????????????????
#.#############.####???????????????????
#...............#??????????????????????
?###############???????????????????????