##?????????????????????????????????????
A.#????????????????????????????????????
#.####?????????????????????????????????
#.#...#????????????????????????????????
#.#.#.####?????????????????????????????
#.#.#.....#????????????????????????????
#.#.#####.##???????????????????????????
#.#.#...#...#??????????????????????????
#.#.#.#.###.#??????????????????????????
#...# #...#.#??????????????????????????
?########.#.##?????????????????????????
#.......#.#...#????????????????????????
?####.#.#.###.#????????????????????????
#...R.#.... #.#????????????????????????
#.####?######.#????????????????????????
#.#...#...#...#????????????????????????
#.#.#.#.#.#.##?????????????????????????
#...#...#.#...#????????????????????????
? ##?####.###.#????????????????????????
??????#... ?#.#????????????????????????
??????#.##??#.#????????????????????????
??????#.#???#.#????????????????????????
??????#.#####.#????????????????????????
??????#.......#????????????????????????
???????#######?????????????????????????
???????????????????????????????????????
???????????????????????????????????????