##?????????????????????????????????????
A.#????????????????????????????????????
#.####?????????????????????????????????
#.#...#????????????????????????????????
#.#.#.####???????????????#?????????????
#.#.#.....#????????????? R#????????????
#.#.#####.##????????????#.#????????????
#.#.#...#...#???????????#.#????????????
#.#.#.#.###.#???????????#.#????????????
#...# #...#.#???????????#.#????????????
?########.#.##?????######.#????????????
#.......#.#...#???#.......#????????????
?####.#.#.###.#???#.######?????????????
#.....#.... #.#???#...#????????????????
#.####?######.#????##.#????????????????
#.#...#...#...#???#...#????????????????
#.#.#.#.#.#.##????#.##?????????????????
#...#...#.#...#???#...#????????????????
#.#######.###.#??####.#????????????????
#.....#... ?#.#?#.....#????????????????
?####.#.##??#.#?#.####?????????????????
#...#.#.#???#.#?#...#??????????????????
#.#.#.#.#####.#####.#??????????????????
#.#...#.......#.....#??????????????????
#.#############.####???????????????????
#...............#??????????????????????
?###############???????????????????????