##?#######?###################?#######?
A.#.......#...................#.......#
#.#####.#.#.#############.###.#.#####.#
#.#...# #.....#...........# #...#...#.#
#.#.#.#######.#.#.#########.#####.#.#.#
#.#.#.....# ..#.# #.......#.#...#.#.#.#
#.#.#####.#####.###.#####.#.#.#.#.#.#.#
#.#.#...#...#...#...#???#.#...#.#.#...#
#.#.#.#.###.#.###.##????#.#####.#.####?
#...# #...#.#..... ?????#.#.....#.....#
?########.#.###.##?######.#.#########.#
#.......#.#...#...#.......#.......#...#
?####.#.#.###.###.#.#######.#####.#.##?
#.....#.... #.# #.#...# #...#?#...#...#
#.####?######.#.#.###.#.#.##??#.#####.#
#.#...#...#...#.#.#...#.#...#?#.......#
#.#.#.#.#.#.###.#.#.###.###.# ########?
#...#...#.#...#...#...#...#.#R.... ????
#.#######.###.#.#####.###.#.# ###.#????
#.....#... ?#.#.#.....#...#.#?#...#????
?####.#.##??#.#.#.#####.###.###.##?????
#...#.#.#???#.# #...# ....#...#.#??????
#.#.#.#.#####.#####.#####.###.#.##?????
#.#...#.......#.....#...... #.#...#????
#.#############.#####.#######.###.#????
#...............#.................#????
?###############?#################?????