##?#######?###################?#######?
A.#.......#...................#.......#
#.#####.#.#.#############.###.#.#####.#
#.#...# #.....#...........# #...#...#.#
#.#.#.#######.#.#.#########.#####.#.#.#
#.#.#.....# ..#.# #.......#.#...#.#.#.#
#.#.#####.#####.###.#####.#.#.#.#.#.#.#
#.#.#...#...#...#...#???#.#...#.#.#...#
#.#.#.#.###.#.###.##????#.#####.#.####?
#...# #...#.#..... ?????#.#.....#.....#
?########.#.###.##?######.#.#########.#
#.......#.#...#...#.......#.......#...#
?####.#.#.###.###.#.#######.#####.#.##?
#.....#.... #.# #.#...#?#...#?#...#...#
#.####?######.#.#.###.#?#.##??#.#####.#
#.#...#...#...#.#.#...#?#...#?#.......#
#.#.#.#.#.#.###.#.#.##???##.#??#######?
#...#...#.#...#...#...#???#.#??????????
#.#######.###.#.#####.#???#.#??????????
#.....#... ?#.#.#.....#???#.#??????????
?####.#.##??#.#.#.####????#.#??????????
#...#.#.#???#.# #...#?????#R ??????????
#.#.#.#.#####.#####.#??????#???????????
#.#...#.......#.....#??????????????????
#.#############.####???????????????????
#...............#??????????????????????
?###############???????????????????????