##?????????????????????????????????????
A.#????????????????????????????????????
#.####?????????????????????????????????
#.#...#????????????????????????????????
#.#.#.####?????????????????????????????
#.#.#.....#????????????????????????????
#.#.#####.##???????????????????????????
#.#.#???#..R#??????????????????????????
#.#.#????## ???????????????????????????
#...#??????????????????????????????????
?###???????????????????????????????????
???????????????????????????????????????
???????????????????????????????????????
???????????????????????????????????????
???????????????????????????????????????
???????????????????????????????????????
???????????????????????????????????????
???????????????????????????????????????
???????????????????????????????????????
???????????????????????????????????????
???????????????????????????????????????
???????????????????????????????????????
???????????????????????????????????????
???????????????????????????????????????
???????????????????????????????????????
???????????????????????????????????????
???????????????????????????????????????