##?????????????????????????????????????
A.#????????????????????????????????????
#.####?????????????????????????????????
#.#...#????????????????????????????????
#.#.#.####?????????????????????????????
#.#.#.....#????????????????????????????
#.#.#####.##???????????????????????????
#.#.#...#...#??????????????????????????
#.#.#.#.###.#??????????????????????????
#...# #...#.#??????????????????????????
?########.#.##?????????????????????????
#.......#.#...#????????????????????????
?####.#.#.###.#????????????????????????
#.....#.... #.#????????????????????????
#.####?######.#????????????????????????
#.#...#...#...#????????????????????????
#.#.#.#.#.#.##?????????????????????????
#...#...#.#...#????????????????????????
#.#######.###.#??#?????????????????????
#.....#... ?#.#?#R ????????????????????
?####.#.##??#.#?#.##???????????????????
#...#.#.#???#.#?#...#??????????????????
#.#.#.#.#####.#####.#??????????????????
#.#...#.......#.....#??????????????????
#.#############.####???????????????????
#...............#??????????????????????
?###############???????????????????????